border_size=1
usage=map

       Mm,       Mm,       Mm,       Mm,       Mm,       Mm,       Mm,       Mm,       Mm,       Mm,       Mm,       Hh,       Hh,       Ww,       Ww,       Hh,       Hh,       Hh,       Mm,       Mm,       Mm,       Mm,       Mm,       Mm,       Mm,       Re,       Mm,       Mm,       Mm,       Mm,       Mm,       Mm,       Mm,       Mm,       Ww,       Wo,       Wo,       Wo,       Wo,       Wo,       Wo,       Wo
       Mm,       Mm,       Mm,       Mm,       Mm,       Mm,       Mm,       Mm,       Mm,       Mm,       Mm,       Hh,       Hh,       Ww,       Ww,       Hh,       Hh,       Hh,       Mm,       Mm,       Mm,       Mm,       Mm,       Mm,       Mm,       Re,       Mm,       Mm,       Mm,       Mm,       Mm,       Mm,       Mm,       Mm,       Ww,       Wo,       Wo,       Wo,       Wo,       Wo,       Wo,       Wo
       Mm,       Mm,       Mm,       Mm,       Mm,       Mm,       Mm,       Mm,       Mm,       Mm,       Mm,       Mm,       Hh,       Ww,       Ww,       Ww,       Ww,       Hh,       Hh,       Hh,       Mm,       Mm,       Mm,       Mm,       Mm,       Re,       Mm,       Mm,       Mm,       Mm,       Mm,       Mm,       Mm,       Mm,       Mm,       Ww,       Wo,       Wo,       Wo,       Wo,       Wo,       Wo
       Mm,       Mm,       Mm,       Mm,       Mm,       Mm,       Mm,       Mm,       Mm,       Mm,       Mm,       Mm,       Mm,       Hh,       Hh,       Ww,       Ww,       Ww,       Ww,       Hh,       Hh,       Mm,       Mm,       Mm,       Mm,       Re,       Mm,       Mm,       Mm,       Mm,       Mm,       Mm,       Mm,       Mm,       Ww,       Ww,       Wo,       Wo,       Wo,       Wo,       Wo,       Wo
       Mm,       Mm,       Mm,       Mm,       Mm,       Mm,       Mm,       Mm,       Mm,       Mm,       Mm,       Mm,       Mm,       Hh,       Hh,       Hh,       Ds,       Ww,       Ww,       Hh,       Hh,       Mm,       Mm,       Mm,       Mm,       Re,       Re,       Mm,       Mm,       Mm,       Mm,       Mm,       Mm,       Ww,       Ww,       Wo,       Wo,       Wo,       Wo,       Wo,       Wo,       Wo
       Mm,       Mm,       Mm,       Mm,       Mm,       Mm,       Mm,       Mm,       Mm,       Mm,       Mm,       Mm,       Mm,       Mm,       Mm,       Hh,       Hh,       Ww,       Ww,       Ds,       Hh,       Hh,       Hh,       Hh,       Hh,       Hh,       Re,       Hh,       Hh,       Mm,       Mm,       Mm,       Mm,       Ww,       Wo,       Wo,       Wo,       Wo,       Wo,       Wo,       Ww,       Ww
       Mm,       Mm,       Mm,       Mm,       Mm,       Mm,       Mm,       Mm,       Mm,       Mm,       Mm,       Mm,       Mm,       Mm,       Hh,       Hh,       Hh,       Ww,       Ww,       Ds,       Gg,       Hh,       Ce,       Hh,       Hh,       Hh,       Re,       Gg,       Ce,       Ce,       Ce,       Gg,       Gg,       Ww,       Wo,       Wo,       Wo,       Wo,       Wo,       Wo,       Ww,       Ww
       Mm,       Mm,       Mm,       Mm,       Mm,       Mm,       Mm,       Hh,       Hh,       Hh,       Hh,       Hh,       Hh,       Hh,       Hh,       Gg,       Gg,       Ww,       Ww,       Ww,       Ds,       Ce,     6 Ke,       Ce,    Gs^Fp,    Gs^Fp,       Re,    Gg^Vh,       Ce,     5 Ke,       Ce,       Gg,       Gg,       Ww,       Wo,       Wo,       Wo,       Wo,       Ww,       Ww,       Ds,       Ds
       Hh,       Hh,       Mm,       Mm,       Mm,       Mm,       Mm,       Hh,       Hh,    Gs^Fp,       Hh,       Hh,       Hh,       Gg,       Gg,    Gs^Fp,       Gg,    Gg^Vh,       Ww,       Ww,       Ds,       Ce,       Ce,       Ce,       Gg,       Gg,       Gg,       Re,       Re,       Ce,       Gg,       Gg,       Gg,       Ww,       Wo,       Wo,       Wo,       Wo,       Ww,       Ds,       Ds,       Ds
       Hh,       Hh,       Hh,       Hh,       Hh,       Hh,       Hh,       Hh,       Ss,       Hh,    Gs^Fp,    Gs^Fp,       Gg,       Re,       Gg,       Gg,       Ww,       Ww,       Ww,       Ww,       Gg,       Gg,       Gg,       Gg,       Gg,       Gg,       Gg,       Gg,       Re,       Gg,       Gg,       Gg,       Gg,       Ww,       Wo,       Wo,       Wo,       Wo,       Wo,       Ww,       Ds,       Ds
    Gs^Fp,    Gs^Fp,    Gs^Fp,       Ss,       Ss,       Ss,       Ss,       Ss,       Ss,    Gs^Fp,    Gs^Fp,    Gg^Vh,    Gs^Fp,       Re,       Re,       Gg,       Ww,       Ww,       Ww,       Ds,       Gg,       Gg,       Gg,       Gg,       Gg,       Gg,       Gg,       Gg,       Re,       Gg,       Gg,       Gg,       Gg,       Ww,       Wo,       Wo,       Wo,       Wo,       Wo,       Ww,       Ds,       Ds
       Re,       Re,       Re,       Hh,    Gs^Fp,       Ss,       Hh,       Hh,       Hh,       Hh,       Hh,    Gs^Fp,    Gs^Fp,    Gs^Fp,       Gg,       Re,       Ds,       Ww,       Ww,       Ww,       Ds,       Gg,       Gg,       Gg,       Gg,       Gg,    Gg^Vh,       Gg,       Re,       Gg,       Gg,       Gg,    Gg^Vh,       Ww,       Ww,       Wo,       Wo,       Wo,       Wo,       Wo,       Ww,       Ww
    Gs^Fp,    Gs^Fp,       Re,    Gs^Fp,    Gs^Fp,       Hh,    Gs^Fp,       Hh,       Hh,       Mm,       Hh,       Hh,    Gs^Fp,       Gg,       Ch,       Re,       Ch,       Ch,       Ww,       Ww,       Ww,       Gg,       Ch,       Gg,       Re,       Re,       Re,       Re,       Gg,       Gg,    Gs^Fp,       Gg,    Gs^Fp,    Gs^Fp,       Ww,       Ww,       Wo,       Wo,       Wo,       Wo,       Wo,       Wo
    Gs^Fp,    Gs^Fp,       Re,    Gs^Fp,    Gs^Fp,    Gs^Fp,    Gs^Fp,       Hh,    Gs^Fp,       Hh,    Gs^Fp,    Gs^Fp,       Ch,       Ch,       Gg,       Re,       Gg,       Gg,       Gg,       Ww,       Ch,       Ww,   Ww^Bw/,       Re,       Gg,       Gg,       Gg,       Gg,    Gs^Fp,       Gg,    Gs^Fp,       Gg,    Gs^Fp,    Gs^Fp,    Gs^Fp,       Ww,       Ww,       Wo,       Wo,       Wo,       Wo,       Wo
    Gs^Fp,    Gs^Fp,    Gs^Fp,       Re,       Re,    Gs^Fp,       Hh,       Hh,       Hh,    Gs^Fp,    Gs^Fp,       Ch,       Gg,       Gg,       Gg,       Re,       Gg,       Gg,       Re,       Re,       Rr,   Ww^Bw/,       Ww,       Ch,       Gg,       Gg,       Gg,       Gg,    Gs^Fp,       Gg,    Gs^Fp,       Gg,       Gg,    Gs^Fp,    Gs^Fp,    Gs^Fp,       Ww,       Ww,       Wo,       Wo,       Wo,       Wo
    Gs^Fp,    Gs^Fp,    Gs^Fp,    Gs^Fp,       Re,    Gs^Fp,    Gs^Fp,    Gs^Fp,    Gs^Fp,    Gs^Fp,       Ch,       Ch,       Gg,       Gg,       Rr,       Rr,       Rr,       Re,    Gg^Vh,       Gg,       Rr,       Ch,       Ww,       Ww,       Ww,       Gg,       Gg,       Gg,    Gs^Fp,    Gs^Fp,       Gg,    Gs^Fp,    Gs^Fp,       Gg,    Gs^Fp,       Gg,       Ww,       Ww,       Wo,       Wo,       Wo,       Wo
    Gs^Fp,    Gs^Fp,    Gs^Fp,    Gs^Fp,       Re,    Gs^Fp,    Gs^Fp,    Gs^Fp,    Gs^Fp,    Gs^Fp,       Ch,       Gg,    Gg^Vh,       Rr,       Ch,       Ch,       Ch,       Rr,    Gg^Vh,       Gg,       Rr,       Ch,     3 Kh,       Ww,       Ww,       Ds,       Gg,       Gg,       Gg,       Gg,    Gs^Fp,    Gg^Vh,       Hh,       Hh,    Gs^Fp,       Gg,       Ww,       Wo,       Wo,       Wo,       Wo,       Wo
    Gs^Fp,    Gs^Fp,    Gs^Fp,    Gs^Fp,    Gs^Fp,       Re,    Gs^Fp,    Gs^Fp,    Gs^Fp,    Gs^Fp,       Ch,       Gg,       Gg,       Rr,       Ch,     4 Kh,       Ch,       Rr,       Gg,       Gg,       Rr,       Ch,       Ch,   Ww^Bw/,       Wo,       Ww,       Ds,       Gg,    Gs^Fp,    Gs^Fp,    Gs^Fp,    Gs^Fp,       Gg,    Gs^Fp,    Gs^Fp,       Ww,       Ww,       Wo,       Wo,       Wo,       Wo,       Wo
    Gs^Fp,    Gs^Fp,    Gs^Fp,    Gs^Fp,       Re,       Re,    Gs^Fp,    Gs^Fp,    Gs^Fp,    Gs^Fp,    Gs^Fp,       Ch,       Gg,       Rr,       Rr,       Ch,       Rr,       Rr,       Gg,    Gg^Vh,    Gg^Vh,       Gg,    Gg^Vh,   Ww^Bw/,       Wo,       Ww,       Gg,       Gg,       Hh,       Gg,       Hh,       Hh,    Gs^Fp,    Gs^Fp,       Ww,       Ww,       Wo,       Wo,       Wo,       Wo,       Wo,       Wo
    Gs^Fp,    Gs^Fp,    Gs^Fp,       Re,    Gs^Fp,    Gs^Fp,    Gs^Fp,       Gg,    Gs^Fp,    Gs^Fp,       Gg,       Ch,       Gg,       Re,       Gg,       Rr,    Gg^Vh,       Gg,       Gg,       Gg,       Gg,       Gg,   Ww^Bw\,       Ww,       Ww,       Ww,       Gg,       Hh,       Gg,       Hh,       Gg,    Gs^Fp,    Gs^Fp,    Gs^Fp,    Gs^Fp,       Ww,       Ww,       Wo,       Wo,       Wo,       Wo,       Wo
    Gs^Fp,    Gs^Fp,    Gs^Fp,       Re,    Gs^Fp,    Gs^Fp,       Gg,    Gs^Fp,       Gg,       Gg,       Gg,       Ch,       Gg,       Re,       Gg,       Gg,       Gg,       Gg,       Gg,       Gg,       Gg,       Ww,       Ww,       Ww,       Ds,       Gg,       Gg,    Gg^Vh,       Gg,       Hh,       Gg,    Gs^Fp,       Hh,       Hh,    Gs^Fp,       Hh,       Ww,       Wo,       Wo,       Wo,       Wo,       Wo
    Gs^Fp,    Gs^Fp,    Gs^Fp,       Re,       Re,    Gs^Fp,       Re,    Gg^Vh,    Gs^Fp,    Gs^Fp,       Re,       Ch,       Re,       Re,       Gg,       Gg,       Gg,       Gg,    Gg^Vh,       Gg,       Gg,       Gg,       Ww,       Ds,       Ds,       Gg,       Ds,       Gg,       Gg,       Gg,       Gg,       Hh,    Gs^Fp,       Hh,       Hh,    Gs^Fp,       Ww,       Ww,       Wo,       Wo,       Wo,       Wo
    Gs^Fp,    Gs^Fp,    Gs^Fp,    Gs^Fp,    Gs^Fp,       Re,    Gs^Fp,       Re,       Re,       Re,       Ch,       Re,       Gg,       Gg,       Gg,    Gg^Vh,       Gg,       Gg,       Gg,       Gg,       Ww,       Ww,       Ww,       Ds,       Ww,      Wwf,      Wwf,      Wwf,       Ww,       Gg,       Hh,       Hh,    Gs^Fp,    Gs^Fp,       Hh,    Gs^Fp,       Ww,       Ww,       Wo,       Wo,       Wo,       Wo
    Gs^Fp,    Gs^Fp,    Gs^Fp,    Gs^Fp,    Gs^Fp,       Gg,    Gs^Fp,       Gg,       Gg,       Gg,       Ss,       Ss,       Ss,    Gg^Vh,       Ss,       Ss,       Ss,       Gg,       Gg,    Gg^Vh,   Ww^Bw\,       Wo,       Wo,       Ww,       Ww,      Wwf,      Wwf,      Wwf,       Ww,       Ww,       Ww,    Gs^Fp,    Gg^Vh,    Gs^Fp,       Ww,       Ww,       Ww,       Ww,       Wo,       Wo,       Wo,       Wo
    Gs^Fp,    Gs^Fp,    Gs^Fp,    Gs^Fp,    Gs^Fp,    Gs^Fp,       Gg,       Gg,       Ss,       Ss,       Ss,       Gg,       Ww,       Ss,       Ss,       Ss,       Ww,       Ww,       Ww,       Ww,       Wo,       Wo,       Wo,       Wo,       Ww,      Wwf,      Wwf,      Wwf,       Ww,       Ww,    Gs^Fp,    Gs^Fp,    Gs^Fp,       Ww,       Ww,       Ww,       Ww,       Wo,       Wo,       Wo,       Wo,       Wo
    Gs^Fp,    Gs^Fp,    Gs^Fp,    Gs^Fp,       Ww,    Gs^Fp,       Ww,    Gs^Fp,       Ww,       Ss,       Ss,       Ww,   Ss^Vhs,       Ss,       Ww,       Ww,       Ww,       Ww,       Ww,       Ww,       Ww,       Ww,       Ww,       Ww,    Gs^Fp,       Re,    Gs^Fp,       Ww,       Ww,       Ww,       Ww,       Ww,       Ww,       Ww,       Ww,       Ww,       Ww,       Wo,       Wo,       Wo,       Wo,       Wo
    Gs^Fp,    Gs^Fp,       Ww,       Ww,       Ww,       Ww,       Ww,       Ww,       Ww,       Ww,       Ww,    Gs^Fp,       Ss,       Ww,       Ww,       Ww,    Gs^Fp,    Gs^Fp,    Gs^Fp,    Gs^Fp,    Gg^Vh,    Gs^Fp,    Gs^Fp,    Gs^Fp,       Re,       Re,    Gs^Fp,    Gg^Vh,    Gs^Fp,       Hh,       Ww,       Ww,       Ww,       Ww,       Ww,    Gs^Fp,       Ww,       Wo,       Wo,       Wo,       Wo,       Wo
       Ww,       Ww,       Ww,       Ww,    Gs^Fp,       Ww,       Hh,       Ww,    Gs^Fp,       Ww,       Ww,       Ww,       Ss,       Ss,       Ss,    Gs^Fp,       Ce,       Ce,       Ce,    Gs^Fp,    Gs^Fp,    Gs^Fp,       Re,       Re,    Gs^Fp,    Gs^Fp,    Gs^Fp,    Gs^Fp,    Gs^Fp,       Hh,       Hh,    Gs^Fp,    Gs^Fp,       Hh,    Gs^Fp,    Gs^Fp,       Hh,       Ww,       Wo,       Wo,       Wo,       Wo
       Ww,       Ww,    Gs^Fp,    Gs^Fp,    Gs^Fp,    Gs^Fp,       Hh,       Hh,       Hh,    Gs^Fp,       Hh,       Ww,       Ss,   Ss^Vhs,    Gs^Fp,    Gs^Fp,       Ce,     1 Ke,       Ce,       Gg,       Gg,       Re,       Ce,       Ce,       Ce,    Gs^Fp,    Gs^Fp,    Gs^Fp,       Hh,       Hh,       Wo,    Gs^Fp,    Gs^Fp,       Hh,       Hh,       Hh,       Ww,       Ww,       Wo,       Wo,       Wo,       Wo
    Gs^Fp,    Gs^Fp,    Gs^Fp,    Gs^Fp,    Gs^Fp,       Gg,    Gs^Fp,       Hh,       Hh,       Hh,    Gs^Fp,    Gs^Fp,    Gs^Fp,    Gs^Fp,    Gs^Fp,    Gs^Fp,    Gs^Fp,       Ce,    Gs^Fp,       Gg,       Gg,       Re,       Ce,     2 Ke,       Ce,    Gs^Fp,    Gs^Fp,    Gs^Fp,       Hh,    Gs^Fp,    Gs^Fp,       Hh,    Gs^Fp,       Hh,    Gs^Fp,       Hh,       Hh,       Ww,       Wo,       Wo,       Wo,       Wo
       Hh,       Hh,    Gs^Fp,    Gs^Fp,    Gs^Fp,    Gs^Fp,    Gs^Fp,       Hh,    Gg^Vh,       Hh,       Hh,    Gs^Fp,    Gs^Fp,       Gg,    Gs^Fp,       Gg,    Gs^Fp,    Gs^Fp,       Gg,       Gg,    Gg^Vh,       Re,    Gs^Fp,       Ce,    Gs^Fp,    Gs^Fp,       Hh,       Hh,    Gs^Fp,    Gs^Fp,       Hh,    Gs^Fp,    Gs^Fp,    Gs^Fp,       Hh,    Gs^Fp,       Ww,       Ww,       Wo,       Wo,       Wo,       Wo
    Gs^Fp,    Gs^Fp,    Gs^Fp,    Gs^Fp,    Gg^Vh,       Gg,    Gs^Fp,    Gs^Fp,    Gs^Fp,    Gs^Fp,       Hh,    Gs^Fp,    Gs^Fp,    Gs^Fp,       Gg,    Gs^Fp,    Gs^Fp,    Gs^Fp,       Re,    Gs^Fp,    Gs^Fp,       Re,    Gs^Fp,    Gs^Fp,    Gs^Fp,    Gg^Vh,       Hh,    Gs^Fp,       Ww,    Gs^Fp,    Gs^Fp,       Hh,    Gs^Fp,    Gs^Fp,    Gs^Fp,       Ww,       Ww,       Wo,       Wo,       Wo,       Wo,       Wo
       Re,       Re,       Re,    Gs^Fp,    Gs^Fp,    Gs^Fp,    Gs^Fp,    Gs^Fp,    Gs^Fp,    Gs^Fp,    Gs^Fp,       Gg,    Gs^Fp,    Gs^Fp,       Re,       Re,       Re,       Re,    Gs^Fp,       Re,       Re,       Re,       Gg,    Gs^Fp,    Gs^Fp,    Gs^Fp,    Gs^Fp,       Ww,       Hh,       Hh,    Gs^Fp,       Hh,    Gs^Fp,    Gs^Fp,       Ww,       Ww,       Ww,       Wo,       Wo,       Wo,       Wo,       Wo
    Gs^Fp,    Gs^Fp,    Gs^Fp,       Re,       Re,       Re,       Re,       Re,       Re,    Gs^Fp,    Gs^Fp,    Gg^Vh,       Re,       Re,    Gs^Fp,    Gs^Fp,       Gg,    Gs^Fp,    Gg^Vh,    Gs^Fp,    Gs^Fp,       Re,       Re,    Gs^Fp,       Hh,       Hh,       Hh,       Hh,       Hh,       Ww,    Gs^Fp,    Gs^Fp,    Gs^Fp,    Gs^Fp,       Hh,       Hh,       Ww,       Wo,       Wo,       Wo,       Wo,       Wo
    Gs^Fp,    Gs^Fp,    Gs^Fp,    Gs^Fp,    Gs^Fp,    Gs^Fp,    Gs^Fp,    Gs^Fp,    Gs^Fp,       Re,       Re,       Re,    Gs^Fp,    Gs^Fp,    Gs^Fp,    Gs^Fp,    Gs^Fp,       Gg,    Gs^Fp,    Gs^Fp,    Gs^Fp,       Re,    Gs^Fp,       Hh,    Gs^Fp,    Gg^Vh,       Hh,       Hh,       Hh,       Hh,    Gs^Fp,    Gs^Fp,       Hh,    Gs^Fp,    Gs^Fp,       Hh,       Ww,       Ww,       Wo,       Wo,       Wo,       Wo
    Gs^Fp,    Gs^Fp,    Gs^Fp,    Gs^Fp,    Gg^Vh,    Gs^Fp,    Gs^Fp,    Gs^Fp,    Gs^Fp,    Gs^Fp,    Gs^Fp,    Gs^Fp,    Gs^Fp,    Gs^Fp,    Gs^Fp,    Gs^Fp,    Gs^Fp,    Gg^Vh,    Gs^Fp,    Gs^Fp,    Gs^Fp,       Re,    Gs^Fp,    Gs^Fp,    Gs^Fp,       Hh,       Hh,       Hh,    Gs^Fp,    Gs^Fp,    Gs^Fp,    Gs^Fp,       Hh,       Hh,    Gs^Fp,    Gs^Fp,       Ww,       Ww,       Wo,       Wo,       Wo,       _s,       _s
    Gs^Fp,    Gs^Fp,    Gs^Fp,    Gs^Fp,    Gg,    Gs^Fp,    Gs^Fp,    Gs^Fp,    Gs^Fp,    Gs^Fp,    Gs^Fp,    Gs^Fp,    Gs^Fp,    Gs^Fp,    Gs^Fp,    Gs^Fp,    Gs^Fp,    Gg,    Gs^Fp,    Gs^Fp,    Gs^Fp,       Re,    Gs^Fp,    Gs^Fp,    Gs^Fp,       Hh,       Hh,       Hh,    Gs^Fp,    Gs^Fp,    Gs^Fp,    Gs^Fp,       Hh,       Hh,    Gs^Fp,    Gs^Fp,       Ww,       Ww,       Wo,       Wo,       Wo,       _s,       _s
