border_size=1
usage=map

       Gg,       Gg,       Gg,       Hh,       Hh,       Hh,       Hh,       Hh,       Mm,       Mm,       Mm,       Hh,       Mm,       Mm,       Mm,       Mm,       Mm,       Hh,       Mm,       Hh,       Hh,       Mm,       Mm,       Mm,       Mm,       Mm,       Mm,       Mm,       Mm,       Mm,       Mm
       Gg,       Gg,       Gg,       Hh,       Hh,       Hh,       Hh,       Hh,       Mm,       Mm,       Mm,       Hh,       Mm,       Mm,       Mm,       Mm,       Mm,       Hh,       Mm,       Hh,       Hh,       Mm,       Mm,       Mm,       Mm,       Mm,       Mm,       Mm,       Mm,       Mm,       Mm
       Gg,       Gg,       Hh,       Hh,       Hh,       Hh,       Hh,       Hh,       Mm,       Gg,       Mm,       Hh,       Mm,       Mm,       Mm,       Mm,       Mm,       Hh,       Hh,       Hh,       Gg,       Gg,       Gg,       Mm,       Mm,       Gg,       Re,       Re,       Re,       Mm,       Mm
       Gg,       Gg,       Hh,       Hh,       Mm,       Mm,       Hh,       Hh,       Mm,       Gg,       Gg,       Hh,       Mm,       Hh,       Mm,       Hh,       Mm,       Mm,    Gg^Ve,       Mm,       Gg,    Gs^Fp,       Gg,       Mm,       Mm,       Mm,       Mm,       Hh,       Gg,       Mm,       Mm
       Gg,       Gg,       Mm,       Mm,       Mm,       Mm,       Mm,       Hh,       Hh,       Gg,       Mm,       Hh,       Hh,       Gg,       Re,       Gg,       Hh,       Mm,       Mm,       Mm,       Gg,    Gs^Fp,       Gg,       Gg,       Gg,       Mm,       Gg,       Mm,       Gg,       Mm,       Mm
       Mm,       Mm,       Gg,       Mm,       Mm,       Mm,       Mm,       Mm,       Mm,       Mm,       Mm,       Mm,       Hh,       Gg,       Re,       Gg,       Hh,       Mm,       Mm,       Gg,       Gg,    Gs^Fp,       Gg,       Gg,       Gg,       Gg,       Mm,       Mm,       Gg,       Mm,       Mm
       Mm,       Mm,       Gg,       Gg,       Gg,       Mm,       Gg,       Mm,       Gg,       Gg,       Mm,       Mm,       Mm,       Gg,       Re,       Gg,       Mm,       Mm,       Gg,       Gg,       Gg,       Gg,    Gs^Fp,    Gs^Fp,       Gg,       Gg,       Gg,       Gg,       Gg,       Mm,       Mm
       Gg,       Gg,       Gg,       Gg,       Hh,       Gg,       Gg,       Gg,       Gg,       Gg,       Gg,       Gg,       Mm,       Hh,       Re,       Hh,       Mm,       Mm,       Gg,       Gg,       Gg,    Gs^Fp,       Gg,    Gs^Fp,       Gg,    Gg^Ve,       Gg,       Gg,       Gg,       Gg,       Gg
       Mm,       Mm,       Mm,       Hh,       Hh,       Hh,    Gg^Ve,       Gg,       Mm,       Mm,       Gg,       Gg,       Mm,      Chr,       Re,      Chr,       Mm,       Hh,       Gg,       Gg,       Gg,       Gg,    Gs^Fp,       Gg,    Gs^Fp,       Gg,       Gg,       Gg,       Gg,       Gg,       Gg
       Mm,       Mm,       Mm,       Mm,       Hh,       Hh,       Gg,       Mm,       Gg,       Mm,       Mm,       Gg,       Gg,       Hh,       Re,       Hh,       Hh,       Hh,       Gg,       Gg,       Gg,       Gg,       Gg,    Gs^Fp,    Gs^Fp,       Gg,       Gg,       Gg,       Gg,    Gg^Ve,    Gg
       Mm,       Mm,       Mm,       Mm,       Mm,       Hh,       Gg,       Gg,       Mm,       Gg,       Gg,       Gg,       Gg,       Gg,       Re,    Gg^Ve,       Hh,       Hh,       Gg,       Gg,       Gg,       Gg,    Gs^Fp,       Gg,       Gg,       Gg,    Gs^Fp,       Gg,       Gg,       Gg,       Gg
       Gg,       Gg,       Gg,       Mm,       Gg,       Gg,       Gg,       Gg,       Mm,       Gg,       Ww,       Ww,       Ww,       Gg,       Gg,       Gg,       Hh,       Hh,       Gg,       Gg,       Gg,       Gg,    Gs^Fp,    Gg^Ve,       Gg,       Gg,    Gs^Fp,    Gs^Fp,       Gg,       Gg,       Gg
       Gg,       Gg,       Gg,       Gg,       Hh,       Hh,       Gg,    Gs^Fp,       Mm,       Mm,       Mm,       Wo,       Wo,       Ww,       Ww,       Gg,       Hh,       Hh,    Gg^Ve,       Gg,       Gg,       Gg,       Gg,       Gg,       Gg,       Gg,       Gg,    Gs^Fp,       Gg,       Gg,       Gg
       Gg,       Gg,      Chr,       Gg,       Hh,       Hh,       Hh,       Gg,       Gg,       Mm,       Mm,       Wo,       Wo,       Wo,       Ww,       Gg,      Chr,      Chr,       Gg,       Gg,       Gg,       Gg,       Gg,       Gg,       Gg,       Gg,    Gs^Fp,    Gs^Fp,    Gs^Fp,       Gg,       Gg
     Ch,     4 Kh,      Chr,       Gg,       Gg,       Hh,    Gs^Fp,    Gs^Fp,       Gg,       Gg,       Mm,       Mm,       Ww,       Ww,       Hh,       Gg,       Gg,      Chr,       Gg,       Gg,       Gg,       Gg,       Gg,       Gg,       Gg,       Gg,       Gg,    Gs^Fp,       Gg,    Gs^Fp,    Gs^Fp
      Chr,      Chr,      Chr,       Gg,       Gg,    Gs^Fp,    Gs^Fp,       Gg,       Gg,       Gg,       Gg,       Mm,       Hh,       Hh,       Hh,       Gg,       Gg,       Gg,       Gg,       Hh,       Hh,       Gg,       Gg,       Gg,       Gg,       Gg,       Gg,       Gg,       Gg,       Gg,       Gg
       Gg,       Gg,       Hh,       Gg,       Gg,    Gs^Fp,    Gs^Fp,       Gg,    Gs^Fp,    Gg^Ve,       Hh,       Mm,       Hh,       Hh,       Gg,       Re,       Hh,       Gg,       Gg,       Hh,       Gg,       Gg,       Gg,    Gg^Ve,       Gg,       Gg,    Gs^Fp,    Gs^Fp,       Gg,       Gg,       Gg
       Gg,       Gg,       Hh,       Hh,       Gg,    Gs^Fp,       Gg,       Gg,       Gg,       Hh,       Gg,       Hh,       Hh,       Hh,       Gg,       Re,       Gg,       Hh,       Gg,       Gg,       Hh,       Gg,       Gg,       Gg,       Gg,       Gg,       Gg,    Gs^Fp,    Gs^Fp,       Gg,       Gg
       Gg,       Gg,       Gg,       Hh,       Gg,       Gg,       Gg,       Gg,       Gg,       Gg,       Gg,    Gs^Fp,       Hh,       Hh,       Gg,       Gg,       Gg,       Gg,       Gg,       Hh,       Hh,       Gg,       Hh,       Gg,    Gs^Fp,    Gs^Fp,    Gs^Fp,    Gs^Fp,    Gs^Fp,       Gg,       Gg
       Gg,       Gg,       Gg,       Gg,       Hh,       Hh,       Hh,       Gg,       Gg,       Gg,    Gs^Fp,    Gs^Fp,    Gs^Fp,       Hh,       Gg,       Gg,       Gg,       Gg,       Gg,       Gg,       Gg,       Gg,       Gg,    Gs^Fp,    Gs^Fp,    Gs^Fp,       Mm,       Mm,       Hh,       Gg,       Gg
       Gg,       Gg,       Gg,       Gg,       Gg,       Hh,       Gg,       Gg,       Gg,    Gs^Fp,    Gs^Fp,    Gs^Fp,    Gs^Fp,      Chr,      Chr,       Gg,       Kh,      Chr,       Gg,       Gg,       Gg,       Gg,       Aa,       Aa,       Mm,       Mm,       Gg,       Hh,       Hh,       Hh,       Hh
       Gg,       Gg,       Gg,       Gg,       Gg,       Gg,       Gg,       Gg,       Gg,    Gs^Fp,    Gs^Fp,    Gs^Fp,    Gs^Fp,      Chr,       Hh,       Gg,       Gg,      Chr,       Gg,       Gg,       Gg,       Aa,       Aa,       Aa,       Aa,    Gs^Fp,    Gg^Ve,       Gg,      Chr,     2 Kh,     Ch
       Gg,       Gg,       Gg,    Gs^Fp,       Gg,    Gs^Fp,       Gg,    Gs^Fp,       Gg,       Gg,    Gs^Fp,    Gs^Fp,    Gs^Fp,       Gg,       Gg,       Gg,       Gg,       Gg,       Gg,       Gg,       Aa,       Aa,   Aa^Vha,       Aa,       Aa,    Gs^Fp,    Gs^Fp,       Gg,      Chr,      Chr,      Chr
       Gg,       Gg,       Gg,       Gg,       Gg,    Gs^Fp,    Gg^Ve,    Gs^Fp,       Gg,       Gg,       Gg,    Gs^Fp,       Gg,       Gg,       Gg,       Gg,       Gg,       Gg,       Gg,       Gg,       Aa,       Aa,       Aa,       Aa,       Aa,    Gs^Fp,    Gs^Fp,       Gg,       Gg,    Gs^Fp,    Gs^Fp
    Gs^Fp,    Gs^Fp,    Gs^Fp,       Gg,       Gg,    Gs^Fp,       Gg,    Gs^Fp,       Gg,       Gg,    Gs^Fp,       Gg,       Gg,       Gg,       Gg,       Re,       Gg,       Gg,    Gg^Ve,       Gg,       Aa,       Aa,       Aa,       Aa,       Aa,    Gs^Fp,       Gg,       Gg,       Gg,    Gs^Fp,    Gs^Fp
    Gs^Fp,    Gs^Fp,    Gs^Fp,    Gs^Fp,    Gs^Fp,       Gg,       Gg,       Gg,    Gs^Fp,    Gs^Fp,    Gs^Fp,       Gg,       Gg,       Gg,       Gg,       Re,       Gg,       Gg,       Gg,       Gg,       Gg,       Gg,       Hh,       Aa,       Aa,    Gs^Fp,       Gg,    Gs^Fp,       Gg,    Gs^Fp,    Gs^Fp
    Gs^Fp,    Gs^Fp,    Gs^Fp,    Gs^Fp,       Gg,    Gs^Fp,       Gg,    Gg^Ve,       Gg,    Gs^Fp,      Chr,       Gg,       Gg,       Gg,       Gg,       Gg,    Gs^Fp,    Gs^Fp,       Gg,       Gg,       Gg,       Hh,       Hh,       Hh,       Aa,       Aa,       Aa,    Gs^Fp,    Gs^Fp,    Gs^Fp,    Gs^Fp
       Gg,       Gg,       Gg,       Gg,       Gg,       Gg,       Aa,       Aa,       Aa,       Gg,      Chr,      Chr,       Gg,       Gg,       Gg,       Gg,    Gs^Fp,    Gs^Fp,    Gs^Fp,       Gg,       Gg,       Gg,       Gg,       Gg,       Aa,       Aa,       Aa,    Gs^Fp,    Gs^Fp,    Gs^Fp,    Gs^Fp
       Gg,       Gg,       Aa,       Aa,       Aa,       Aa,       Aa,       Aa,       Aa,       Gg,       Gg,       Gg,    Gs^Fp,       Gg,       Gg,       Re,    Gs^Fp,    Gs^Fp,    Gs^Fp,       Gg,       Gg,       Gg,       Gg,    Gg^Ve,       Aa,       Aa,    Gs^Fp,    Gs^Fp,    Gs^Fp,       Gg,       Gg
       Gg,       Gg,       Gg,       Gg,       Aa,       Aa,       Aa,       Aa,       Aa,       Gg,    Gs^Fp,    Gs^Fp,    Gs^Fp,       Gg,       Re,       Gg,    Gs^Fp,    Gs^Fp,    Gs^Fp,    Gs^Fp,       Gg,       Gg,       Gg,       Gg,       Gg,       Aa,    Gs^Fp,    Gs^Fp,    Gs^Fp,       Gg,       Gg
       Gg,       Gg,       Gg,    Gg^Ve,       Gg,       Aa,       Aa,       Aa,       Aa,       Gg,    Gs^Fp,    Gs^Fp,    Gs^Fp,       Gg,       Re,       Gg,    Gs^Fp,    Gs^Fp,       Mm,    Gs^Fp,       Gg,       Gg,       Mm,       Gg,       Gg,       Gg,       Gg,       Gg,    Gs^Fp,       Gg,       Gg
       Gg,       Gg,       Gg,       Gg,       Aa,       Aa,       Aa,       Aa,       Aa,       Gg,    Gs^Fp,    Gs^Fp,    Gs^Fp,       Gg,       Gg,       Gg,       Gg,    Gs^Fp,       Mm,       Mm,       Mm,       Gg,       Mm,    Gg^Ve,       Gg,       Gg,       Gg,       Gg,    Gs^Fp,       Gg,       Gg
       Gg,       Gg,       Gg,       Gg,       Gg,       Aa,       Aa,       Aa,       Aa,       Gg,       Gg,    Gs^Fp,    Gs^Fp,    Gs^Fp,       Gg,       Gg,       Gg,       Hh,       Hh,       Mm,       Mm,       Mm,       Mm,       Gg,       Gg,       Gg,       Gg,       Gg,       Gg,       Gg,       Gg
       Gg,       Gg,       Gg,       Gg,       Hh,       Hh,       Hh,       Aa,       Gg,       Mm,       Mm,    Gs^Fp,    Gs^Fp,    Gs^Fp,    Gs^Fp,       Gg,       Gg,       Hh,       Hh,       Hh,       Hh,       Mm,       Mm,       Mm,       Gg,       Gg,       Gg,       Gg,       Mm,       Gg,       Gg
      Chr,      Chr,      Chr,       Gg,       Hh,      Chr,       Hh,       Gg,       Gg,       Gg,       Mm,    Gs^Fp,       Hh,       Hh,    Gs^Fp,       Gg,       Re,       Gg,       Gg,       Hh,       Hh,       Hh,       Hh,       Mm,       Mm,       Gg,       Gg,       Mm,       Mm,       Gg,       Gg
     Ch,     3 Kh,      Chr,       Gg,       Hh,       Hh,       Hh,       Gg,       Gg,       Gg,       Mm,    Gs^Fp,    Gs^Fp,    Gs^Fp,       Hh,    Gg^Ve,       Gg,       Re,       Gg,       Gg,       Gg,       Hh,       Hh,       Mm,       Mm,       Mm,       Gg,       Mm,       Mm,       Mm,       Mm
      Chr,      Chr,       Gg,       Gg,       Gg,       Gg,       Gg,       Gg,       Gg,       Gg,       Gg,       Mm,       Mm,       Mm,       Hh,       Hh,       Gg,       Gg,       Gg,       Re,       Re,       Gg,       Hh,       Mm,       Mm,       Mm,       Gg,    Gg^Ve,       Mm,       Mm,       Mm
       Gg,       Gg,    Gs^Fp,    Gs^Fp,    Gs^Fp,    Gs^Fp,    Gs^Fp,       Gg,       Gg,       Gg,       Gg,       Hh,       Mm,       Mm,       Hh,       Hh,       Gg,       Gg,       Gg,       Gg,       Re,       Gg,    Gg^Ve,       Hh,       Mm,       Mm,       Mm,       Hh,       Hh,       Mm,       Mm
    Gs^Fp,    Gs^Fp,       Hh,       Hh,       Hh,    Gs^Fp,    Gs^Fp,       Gg,       Gg,       Gg,       Gg,       Hh,       Mm,       Mm,       Hh,       Hh,       Gg,       Gg,       Gg,       Re,       Gg,       Gg,       Gg,       Hh,       Mm,       Mm,       Mm,       Hh,       Hh,       Mm,       Mm
       Mm,       Mm,       Mm,       Mm,       Mm,       Mm,       Hh,    Gs^Fp,       Gg,       Gg,    Gg^Ve,       Hh,       Mm,       Mm,       Hh,       Hh,    Gg^Ve,       Gg,       Gg,       Gg,       Gg,       Gg,       Gg,       Hh,       Mm,       Mm,       Hh,       Hh,       Hh,       Mm,       Mm
       Mm,       Mm,       Hh,       Mm,       Mm,       Mm,       Mm,    Gs^Fp,       Gg,       Gg,       Hh,       Hh,       Mm,       Mm,       Hh,       Hh,       Hh,       Gg,       Gg,       Re,       Re,       Gg,       Hh,       Hh,       Mm,       Mm,       Mm,       Hh,       Mm,       Mm,       Mm
       Mm,       Mm,       Mm,       Mm,       Mm,       Mm,       Mm,       Mm,       Gg,       Gg,       Hh,       Mm,       Mm,       Mm,       Mm,       Hh,       Hh,       Gg,       Gg,       Gg,       Re,       Gg,       Gg,       Hh,       Mm,       Mm,       Hh,       Hh,       Mm,       Mm,       Mm
       Mm,       Mm,       Mm,       Mm,       Mm,       Hh,    Gs^Fp,       Mm,       Mm,       Gg,       Gg,       Mm,       Mm,       Mm,       Mm,       Hh,       Hh,       Hh,       Hh,       Gg,       Ce,       Gg,       Gg,       Hh,       Mm,       Mm,       Hh,       Mm,       Mm,       Mm,       Mm
       Mm,       Mm,       Mm,       Hh,       Mm,    Gs^Fp,    Gs^Fp,    Gs^Fp,    Gs^Fp,    Gs^Fp,    Gs^Fp,       Mm,       Mm,       Mm,       Mm,       Mm,       Mm,       Hh,       Hh,       Ce,     1 Ke,       Ce,       Hh,       Hh,       Mm,       Mm,       Mm,       Hh,       Mm,       Mm,       Mm
       Mm,       Mm,       Mm,       Hh,       Hh,       Hh,       Mm,    Gs^Fp,    Gs^Fp,    Gs^Fp,       Mm,       Mm,       Mm,       Mm,       Mm,       Mm,       Mm,       Hh,       Hh,       Ce,       Re,       Ce,       Hh,       Mm,       Mm,       Mm,       Mm,       Hh,       Hh,       Mm,       Mm
       Mm,       Mm,       Mm,    Gs^Fp,       Hh,       Hh,       Mm,    Gs^Fp,    Gs^Fp,       Mm,       Mm,       Mm,       Mm,       Mm,       Mm,       Mm,       Mm,       Mm,       Mm,       Hh,       Re,       Hh,       Mm,       Mm,       Mm,       Mm,       Mm,       Mm,       Mm,       Mm,       Mm
       Mm,       Mm,       Mm,    Gs^Fp,       Hh,       Hh,       Mm,    Gs^Fp,    Gs^Fp,       Mm,       Mm,       Mm,       Mm,       Mm,       Mm,       Mm,       Mm,       Mm,       Mm,       Hh,       Re,       Hh,       Mm,       Mm,       Mm,       Mm,       Mm,       Mm,       Mm,       Mm,       Mm
