border_size=1
usage=map

       Mm,       Mm,       Mm,       Mm,       Mm,       Mm,       Mm,       Mm,       Mm,       Mm,       Mm,       Mm,       Mm,       Hh,       Hh,       Hh,       Hh,       Mm,       Mm,       Mm,       Hh,       Hh,       Gg,       Gg,       Gg,       Gg,       Gg,       Gg,       Gg,    Gs^Fp,    Gs^Fp,    Gs^Fp
       Mm,       Mm,       Mm,       Mm,       Mm,       Mm,       Mm,       Mm,       Mm,       Mm,       Mm,       Mm,       Mm,       Hh,       Hh,       Hh,       Hh,       Mm,       Mm,       Mm,       Hh,       Hh,       Gg,       Gg,       Gg,       Gg,       Gg,       Gg,       Gg,    Gs^Fp,    Gs^Fp,    Gs^Fp
       Mm,       Mm,       Mm,       Mm,       Mm,       Mm,       Hh,       Mm,       Mm,       Mm,       Hh,       Hh,       Hh,       Hh,       Hh,       Hh,       Hh,       Hh,       Mm,       Hh,       Hh,       Gg,       Gg,       Gg,       Gg,       Gg,       Gg,       Gg,       Gg,    Gs^Fp,    Gs^Fp,    Gs^Fp
       Mm,       Mm,       Mm,       Mm,       Mm,       Mm,       Mm,       Hh,       Hh,       Mm,       Mm,       Hh,       Hh,       Hh,       Gg,       Ch,       Ch,       Hh,       Hh,       Hh,       Hh,       Gg,       Gg,       Gg,       Gg,       Gg,       Gg,       Gg,    Gg^Ve,       Gg,    Gs^Fp,    Gs^Fp
       Mm,       Mm,       Mm,       Hh,       Mm,       Mm,       Mm,       Hh,       Hh,       Hh,       Hh,       Hh,       Hh,       Gg,       Ch,     1 Kh,       Ch,       Gg,       Hh,       Hh,       Gg,       Gg,    Gs^Fp,    Gs^Fp,       Gg,       Gg,       Gg,       Gg,       Gg,       Gg,    Gs^Fp,    Gs^Fp
       Mm,       Mm,       Mm,       Mm,       Hh,       Mm,       Mm,       Hh,       Hh,       Hh,       Hh,       Mm,       Mm,       Hh,       Hh,       Ch,       Ch,       Gg,       Gg,       Hh,       Hh,       Gg,    Gs^Fp,    Gs^Fp,       Gg,       Gg,       Gg,       Gg,       Gg,       Gg,       Gg,       Gg
       Mm,       Mm,       Hh,       Hh,       Hh,       Mm,       Hh,       Hh,       Hh,       Hh,       Hh,       Hh,       Mm,       Hh,       Hh,       Gg,       Gg,       Gg,    Gg^Ve,       Hh,       Gg,       Gg,    Gs^Fp,    Gs^Fp,       Gg,       Gg,       Gg,       Gg,       Gg,       Gg,    Gs^Fp,    Gs^Fp
       Mm,       Mm,       Mm,       Hh,       Hh,       Hh,       Hh,       Hh,       Hh,       Hh,       Gg,       Gg,       Hh,       Mm,       Hh,       Gg,       Gg,       Gg,       Gg,       Gg,       Gg,       Gg,       Gg,    Gs^Fp,    Gs^Fp,       Gg,       Gg,       Gg,       Gg,       Gg,       Gg,       Gg
       Mm,       Mm,       Hh,       Hh,       Hh,       Hh,       Hh,       Hh,       Gg,       Hh,       Gg,       Hh,       Hh,       Hh,       Hh,       Hh,       Gg,       Gg,       Gg,       Gg,       Gg,       Gg,       Gg,    Gs^Fp,       Gg,       Gg,       Gg,       Gg,       Gg,       Gg,    Gs^Fp,    Gs^Fp
       Mm,       Mm,       Mm,       Hh,       Hh,       Hh,    Gg^Ve,       Hh,       Gg,    Gs^Fp,    Gs^Fp,       Gg,       Gg,       Gg,    Gg^Ve,       Hh,       Gg,       Gg,       Gg,       Gg,       Gg,       Gg,       Gg,       Gg,    Gs^Fp,       Gg,       Gg,       Gg,       Gg,       Gg,       Gg,       Gg
       Mm,       Mm,       Mm,       Hh,       Hh,       Hh,       Hh,       Gg,       Gg,    Gs^Fp,    Gs^Fp,    Gs^Fp,       Gg,       Gg,       Gg,       Gg,       Gg,       Gg,       Gg,       Gg,       Gg,       Gg,       Gg,       Gg,       Gg,       Gg,       Gg,       Gg,       Gg,       Gg,       Gg,       Gg
       Mm,       Mm,       Mm,       Hh,       Hh,       Hh,       Hh,       Hh,       Hh,       Gg,    Gs^Fp,    Gs^Fp,    Gs^Fp,       Gg,       Gg,       Gg,       Gg,       Gg,       Gg,       Gg,       Gg,       Gg,       Gg,       Gg,       Gg,       Gg,       Gg,       Gg,       Gg,       Gg,       Gg,       Gg
       Mm,       Mm,       Mm,       Hh,       Hh,       Hh,       Hh,       Hh,       Hh,       Gg,       Gg,    Gs^Fp,    Gs^Fp,       Gg,       Gg,       Gg,       Gg,    Gg^Ve,       Gg,       Gg,       Gg,       Gg,       Gg,       Gg,       Gg,       Gg,       Gg,       Gg,       Gg,       Gg,       Re,       Re
       Mm,       Mm,       Mm,       Hh,       Hh,       Hh,       Hh,       Hh,       Re,       Hh,       Gg,       Gg,    Gs^Fp,    Gs^Fp,       Gg,       Gg,       Gg,       Gg,       Gg,       Gg,       Gg,       Gg,       Gg,       Gg,       Gg,       Gg,       Gg,       Gg,       Gg,       Gg,       Re,       Re
       Mm,       Mm,       Mm,       Hh,       Hh,       Hh,       Hh,       Re,       Hh,       Hh,       Gg,       Gg,       Gg,       Gg,       Gg,       Gg,       Gg,       Gg,       Gg,       Gg,       Gg,       Gg,       Gg,       Gg,       Gg,       Gg,       Gg,    Gs^Fp,       Gg,       Re,       Gg,       Gg
       Mm,       Mm,       Mm,       Hh,       Hh,       Hh,       Hh,       Re,       Hh,       Hh,       Hh,       Gg,       Gg,       Gg,       Gg,       Gg,       Gg,       Gg,       Gg,       Gg,       Gg,    Gg^Ve,       Gg,       Gg,       Gg,       Gg,    Gs^Fp,    Gs^Fp,       Gg,       Re,       Gg,       Gg
       Mm,       Mm,       Mm,       Hh,       Hh,       Hh,       Gg,       Re,       Re,       Re,       Hh,       Gg,       Gg,       Gg,    Gg^Ve,       Gg,       Gg,       Gg,       Gg,       Gg,       Gg,       Gg,       Kh,       Gg,    Gs^Fp,    Gs^Fp,    Gs^Fp,       Gg,       Re,       Gg,       Gg,       Gg
       Mm,       Mm,       Mm,       Hh,       Hh,       Hh,       Gg,       Gg,       Gg,       Gg,       Re,       Gg,       Gg,       Gg,       Gg,       Gg,       Gg,       Ww,       Ww,       Ww,       Ww,       Gg,       Ch,       Ch,       Gg,    Gs^Fp,    Gs^Fp,       Gg,       Re,       Gg,    Gs^Fp,    Gs^Fp
       Mm,       Mm,       Hh,       Hh,       Hh,       Hh,       Gg,       Gg,       Gg,       Gg,       Re,    Gg^Ve,       Gg,       Gg,       Gg,       Ww,       Ww,       Wo,       Wo,       Wo,       Ww,       Gg,       Gg,       Gg,       Gg,       Gg,       Re,       Re,       Gg,    Gs^Fp,    Gs^Fp,    Gs^Fp
       Mm,       Mm,       Mm,       Hh,       Hh,       Hh,       Hh,       Gg,       Gg,       Gg,       Re,       Re,       Gg,       Gg,       Gg,       Ww,       Wo,       Wo,       Wo,       Wo,       Wo,       Ww,       Gg,       Gg,       Re,       Re,       Re,       Re,       Gg,    Gs^Fp,    Gs^Fp,    Gs^Fp
       Mm,       Mm,       Hh,       Hh,       Hh,       Hh,       Hh,       Gg,       Gg,       Re,       Gg,       Gg,       Gg,       Gg,       Gg,       Ww,       Wo,       Wo,       Wo,       Ww,       Ww,       Gg,       Gg,       Re,       Re,       Gg,       Gg,       Gg,    Gs^Fp,    Gs^Fp,    Gs^Fp,    Gs^Fp
       Mm,       Mm,       Mm,       Hh,       Hh,       Gg,       Gg,       Hh,       Gg,       Gg,       Re,       Gg,       Gg,       Gg,       Gg,       Ww,       Wo,       Wo,       Wo,       Wo,       Ww,       Ww,       Gg,       Gg,       Gg,       Re,       Gg,       Gg,       Gg,    Gs^Fp,    Gs^Fp,    Gs^Fp
       Mm,       Mm,       Hh,       Hh,       Gg,       Gg,       Gg,       Gg,       Gg,       Gg,       Re,       Gg,       Gg,       Gg,       Ww,       Wo,       Wo,       Wo,       Wo,       Wo,       Ww,       Gg,       Gg,       Gg,       Re,       Re,       Gg,       Gg,    Gs^Fp,    Gs^Fp,    Gs^Fp,    Gs^Fp
       Mm,       Mm,       Hh,       Hh,       Gg,       Gg,       Gg,       Gg,       Gg,       Re,       Re,       Gg,    Gs^Fp,    Gs^Fp,       Ww,       Wo,       Wo,       Wo,       Wo,       Wo,       Ww,       Gg,       Re,       Re,       Re,       Re,       Gg,       Gg,    Gs^Fp,    Gs^Fp,    Gs^Fp,    Gs^Fp
       Mm,       Mm,       Hh,       Hh,       Gg,    Gg^Ve,       Gg,       Gg,       Re,       Re,       Gg,       Gg,       Gg,       Ww,       Wo,       Wo,       Ww,       Ww,       Ww,       Ww,       Gg,       Gg,       Gg,       Gg,       Re,       Re,       Gg,       Gg,    Gs^Fp,    Gs^Fp,    Gs^Fp,    Gs^Fp
       Hh,       Hh,       Hh,       Hh,       Gg,       Gg,       Gg,       Gg,    Gs^Fp,       Gg,       Gg,       Gg,       Gg,       Ww,       Wo,       Wo,       Ww,       Gg,    Gg^Ve,       Gg,       Gg,       Gg,       Gg,       Gg,       Gg,       Re,       Re,       Gg,       Gg,    Gs^Fp,    Gs^Fp,    Gs^Fp
       Hh,       Hh,       Hh,       Gg,       Gg,       Gg,       Gg,    Gs^Fp,    Gs^Fp,       Gg,       Gg,       Gg,       Gg,       Ww,       Wo,       Ww,       Gg,       Gg,       Gg,       Gg,       Gg,       Gg,       Gg,       Gg,       Gg,       Re,       Gg,       Gg,    Gs^Fp,    Gs^Fp,    Gs^Fp,    Gs^Fp
       Hh,       Hh,       Gg,       Gg,       Gg,       Gg,       Gg,    Gs^Fp,       Gg,       Gg,       Ww,       Ww,   Ww^Bw|,       Ww,       Ww,       Ww,       Gg,       Gg,       Gg,       Gg,       Gg,       Gg,       Gg,       Gg,       Gg,    Gg^Ve,       Re,       Gg,       Gg,    Gs^Fp,    Gs^Fp,    Gs^Fp
       Gg,       Gg,       Gg,       Gg,       Gg,       Gg,       Gg,       Gg,       Ww,       Ww,       Ww,       Ch,       Gg,       Ch,       Gg,       Gg,       Gg,       Gg,       Gg,       Gg,       Gg,       Gg,       Gg,       Gg,       Gg,       Gg,       Re,       Gg,       Gg,    Gs^Fp,    Gs^Fp,    Gs^Fp
       Hh,       Hh,       Gg,       Gg,       Gg,       Gg,       Gg,       Gg,       Ww,       Gg,       Gg,       Gg,       Gg,       Gg,       Gg,    Gs^Fp,       Gg,       Gg,       Gg,       Gg,       Gg,       Gg,       Gg,       Gg,       Gg,       Gg,       Gg,       Re,       Gg,       Gg,    Gs^Fp,    Gs^Fp
       Hh,       Hh,       Hh,    Gs^Fp,    Gs^Fp,       Gg,       Gg,       Ww,       Gg,       Gg,       Gg,       Gg,       Gg,       Gg,       Gg,    Gs^Fp,       Gg,       Gg,       Gg,       Gg,       Gg,       Gg,       Gg,       Gg,       Gg,       Gg,       Re,       Gg,       Gg,       Gg,    Gs^Fp,    Gs^Fp
       Hh,       Hh,       Hh,    Gs^Fp,    Gg^Ve,       Gg,       Gg,       Ww,       Ch,       Gg,       Gg,       Gg,       Gg,       Gg,       Gg,    Gs^Fp,    Gs^Fp,       Gg,       Gg,       Gg,       Gg,       Gg,       Gg,       Gg,       Gg,       Gg,       Gg,       Re,       Gg,       Gg,       Gg,       Gg
       Hh,       Hh,       Hh,       Gg,       Gg,       Gg,       Gg,       Gg,   Ww^Bw/,       Gg,       Gg,       Gg,       Gg,       Gg,       Gg,    Gs^Fp,       Gg,       Gg,       Gg,       Gg,       Gg,       Gg,       Gg,       Gg,       Gg,       Gg,       Gg,       Re,       Gg,       Gg,       Gg,       Gg
       Hh,       Hh,       Hh,       Hh,       Gg,       Gg,       Gg,       Gg,       Ww,       Ch,       Gg,       Gg,       Gg,       Gg,       Gg,       Gg,    Gs^Fp,       Gg,       Gg,       Gg,       Gg,       Gg,       Gg,    Gg^Ve,       Gg,       Gg,       Gg,    Gg^Ve,       Re,       Gg,       Gg,       Gg
       Hh,       Hh,       Hh,       Gg,       Gg,       Gg,       Gg,       Gg,       Ww,       Gg,    Gg^Ve,       Gg,       Gg,       Gg,       Gg,       Gg,       Gg,       Gg,       Gg,       Gg,       Gg,       Gg,       Gg,       Gg,       Gg,       Gg,       Gg,       Gg,       Re,       Re,       Gg,       Gg
       Hh,       Hh,       Hh,       Gg,       Gg,       Gg,       Gg,       Gg,       Ww,       Gg,       Gg,       Gg,       Gg,       Gg,       Gg,       Gg,    Gg^Ve,       Gg,       Gg,       Gg,       Gg,       Gg,    Gs^Fp,    Gs^Fp,       Gg,       Gg,       Gg,       Gg,       Gg,       Re,       Re,       Re
       Hh,       Hh,       Gg,       Gg,       Gg,       Gg,       Ww,       Ww,       Gg,       Gg,       Gg,       Gg,       Gg,       Gg,       Gg,       Gg,       Gg,       Gg,       Gg,       Gg,       Gg,    Gs^Fp,    Gs^Fp,    Gs^Fp,       Gg,       Gg,       Gg,       Gg,       Gg,       Gg,       Re,       Re
       Hh,       Hh,       Hh,       Gg,       Gg,       Ww,       Ww,       Ww,       Gg,       Gg,       Gg,       Gg,       Gg,       Gg,       Gg,       Gg,       Gg,       Gg,       Gg,       Gg,       Gg,       Gg,    Gs^Fp,    Gs^Fp,    Gs^Fp,    Gs^Fp,    Gs^Fp,       Gg,       Gg,       Ch,       Ch,       Ch
       Hh,       Hh,       Hh,       Gg,       Ww,       Ww,       Gg,       Gg,       Gg,       Gg,       Gg,       Gg,       Gg,       Gg,       Gg,       Gg,       Gg,       Gg,       Gg,       Gg,       Gg,    Gs^Fp,    Gs^Fp,    Gs^Fp,    Gs^Fp,    Gs^Fp,    Gs^Fp,    Gs^Fp,       Gg,     2 Kh,       Ch,       Ch
       Hh,       Hh,       Hh,       Gg,       Ww,       Ww,       Gg,       Gg,       Gg,       Gg,       Gg,       Gg,       Gg,       Gg,       Gg,       Gg,       Gg,       Gg,       Gg,       Gg,       Gg,    Gs^Fp,    Gs^Fp,    Gs^Fp,    Gs^Fp,    Gs^Fp,    Gs^Fp,    Gs^Fp,       Gg,     Ch,       Ch,       Ch
