border_size=1
usage=map

       Gg,       Gg,       Gg,       Gg,       Gg,       Gg,       Gg,       Gg,       Gg,       Gg,       Gg,       Gg,       Gg,    Gs^Fp,    Gs^Fp,    Gg,    Gs^Fp,    Gs^Fp,    Gs^Fp,    Gs^Fp,    Gs^Fp,       Hh,    Gs^Fp,    Gs^Fp,    Gs^Fp,       Hh,       Hh,       Hh,    Gs^Fp,    Gs^Fp,       Ww,    Gs^Fp,       Wo,       Wo,       Ww,    Gs^Fp,    Gs^Fp,    Gs^Fp
       Gg,       Gg,       Gg,       Gg,       Gg,       Gg,       Gg,       Gg,       Gg,       Gg,       Gg,       Gg,       Gg,    Gs^Fp,    Gs^Fp,    Gg^Vh,    Gs^Fp,    Gs^Fp,    Gs^Fp,    Gs^Fp,    Gs^Fp,       Hh,    Gs^Fp,    Gs^Fp,    Gs^Fp,       Hh,       Hh,       Hh,    Gs^Fp,    Gs^Fp,       Ww,    Gs^Fp,       Wo,       Wo,       Ww,    Gs^Fp,    Gs^Fp,    Gs^Fp
       Gg,       Gg,       Gg,    Gg^Vh,       Gg,       Gg,       Gg,       Gg,       Gg,       Gg,       Gg,       Gg,       Gg,       Gg,    Gs^Fp,    Gs^Fp,    Gs^Fp,    Gs^Fp,    Gs^Fp,    Gs^Fp,    Gs^Fp,    Gs^Fp,    Gs^Fp,    Gs^Fp,    Gs^Fp,       Hh,       Hh,    Gs^Fp,    Gs^Fp,    Gs^Fp,    Gs^Fp,       Ww,       Ww,   Ww^Bw\,    Gs^Fp,       Ww,       Ww,       Ww
       Gg,       Gg,       Gg,       Gg,    Gs^Fp,       Gg,    Gs^Fp,    Gg^Vh,    Gs^Fp,       Gg,       Gg,       Gg,       Gg,       Gg,       Gg,       Gg,    Gs^Fp,    Gg^Vh,       Re,    Gs^Fp,       Re,    Gs^Fp,    Gs^Fp,       Wo,    Gs^Fp,       Hh,    Gs^Fp,    Gs^Fp,       Re,    Gs^Fp,       Re,    Gs^Fp,    Gs^Fp,    Gs^Fp,       Re,    Gs^Fp,    Gs^Fp,    Gs^Fp
       Gg,       Gg,       Gg,       Gg,    Gs^Fp,    Gs^Fp,       Ww,    Gs^Fp,    Gs^Fp,       Gg,       Gg,       Gg,       Gg,       Gg,       Gg,       Gg,       Gg,       Re,    Gs^Fp,       Re,    Gg^Vh,       Re,    Gs^Fp,    Gs^Fp,       Re,       Re,       Re,       Re,    Gs^Fp,       Re,    Gs^Fp,       Re,    Gs^Fp,       Re,    Gs^Fp,       Re,       Re,       Re
       Gg,       Gg,    Gg^Vh,       Gg,    Gs^Fp,       Ww,    Gs^Fp,       Gg,       Gg,       Gg,       Gg,       Gg,       Gg,       Gg,       Gg,       Gg,       Gg,    Gs^Fp,       Ww,    Gs^Fp,    Gs^Fp,    Gs^Fp,    Gs^Fp,       Re,    Gs^Fp,    Gs^Fp,    Gs^Fp,    Gs^Fp,    Gs^Fp,    Gs^Fp,    Gs^Fp,   Ss^Vhs,       Ss,    Gs^Fp,   Ss^Vhs,    Gs^Fp,    Gs^Fp,    Gs^Fp
       Gg,       Gg,       Gg,       Gg,       Gg,    Gs^Fp,       Gg,       Gg,       Gg,       Gg,       Gg,       Gg,       Gg,       Gg,       Gg,       Gg,       Gg,    Gs^Fp,    Gs^Fp,       Ww,    Gs^Fp,    Gs^Fp,       Ww,    Gs^Fp,    Gs^Fp,    Gs^Fp,    Gs^Fp,    Gs^Fp,    Gs^Fp,       Ww,       Ww,       Ss,       Ss,       Ss,       Ww,       Ww,       Ww,       Ww
       Gg,       Gg,       Gg,       Gg,       Gg,       Gg,       Gg,       Gg,       Gg,       Gg,       Gg,    Gg^Vh,       Gg,       Gg,       Gg,       Gg,       Gg,       Gg,       Gg,    Gs^Fp,    Gs^Fp,       Ww,    Gs^Fp,    Gs^Fp,    Gs^Fp,    Gs^Fp,    Gs^Fp,    Gs^Fp,    Gs^Fp,       Ww,   Ww^Bw/,    Gs^Fp,       Ww,       Ww,    Gs^Fp,       Ww,    Gs^Fp,    Gs^Fp
       Gg,       Gg,       Hh,       Hh,       Hh,       Hh,       Hh,       Gg,       Gg,       Gg,       Gg,       Gg,       Gg,       Gg,       Gg,       Gg,       Gg,       Gg,       Gg,       Gg,    Gs^Fp,    Gs^Fp,    Gs^Fp,    Gs^Fp,       Ss,    Gs^Fp,    Gs^Fp,    Gs^Fp,    Gs^Fp,    Gs^Fp,    Gs^Fp,       Ww,       Ss,       Ss,       Ss,    Gs^Fp,    Gs^Fp,    Gs^Fp
       Hh,       Hh,    Gs^Fp,       Gg,       Gg,       Gg,       Gg,       Hh,       Hh,       Gg,       Gg,       Gg,       Gg,       Gg,       Gg,       Gg,       Gg,       Gg,       Gg,       Gg,       Gg,    Gs^Fp,    Gs^Fp,    Gs^Fp,    Gs^Fp,       Ss,    Gs^Fp,    Gs^Fp,    Gs^Fp,    Gs^Fp,    Gs^Fp,       Ss,    Gs^Fp,   Ss^Vhs,    Gs^Fp,    Gs^Fp,    Gs^Fp,    Gs^Fp
       Gg,       Gg,       Gg,       Gg,       Gg,       Gg,       Gg,    Gg^Vh,       Hh,       Gg,       Gg,       Gg,       Gg,       Gg,       Gg,       Gg,       Gg,       Gg,       Gg,       Gg,    Gs^Fp,    Gs^Fp,       Gg,    Gs^Fp,       Gg,    Gs^Fp,    Gs^Fp,       Hh,       Hh,    Gs^Fp,    Gs^Fp,    Gs^Fp,    Gs^Fp,    Gs^Fp,    Gs^Fp,    Gs^Fp,    Gs^Fp,    Gs^Fp
       Gg,       Gg,       Hh,       Hh,       Hh,       Gg,       Gg,       Gg,       Gg,       Gg,       Gg,       Gg,       Gg,       Gg,       Gg,       Gg,       Gg,       Gg,       Gg,       Gg,    Gs^Fp,       Gg,       Gg,       Gg,       Gg,    Gs^Fp,    Gs^Fp,       Hh,    Gs^Fp,    Gs^Fp,    Gs^Fp,    Gs^Fp,    Gs^Fp,    Gs^Fp,    Gs^Fp,    Gs^Fp,    Gs^Fp,    Gs^Fp
       Hh,       Hh,    Gs^Fp,       Rr,    Gs^Fp,       Hh,       Hh,       Gg,       Gg,       Gg,       Gg,       Gg,       Gg,       Gg,       Hh,       Gg,       Gg,       Gg,       Gg,       Gg,       Gg,    Gs^Fp,    Gs^Fp,    Gs^Fp,    Gs^Fp,    Gs^Fp,    Gs^Fp,    Gs^Fp,    Gs^Fp,    Gs^Fp,    Gs^Fp,    Gs^Fp,    Gs^Fp,    Gs^Fp,    Gs^Fp,    Gs^Fp,    Gs^Fp,    Gs^Fp
       Rr,       Rr,     3 Kh,       Ch,       Ch,       Rr,       Hh,       Gg,       Gg,       Gg,       Gg,       Gg,       Gg,       Hh,       Gg,       Hh,       Gg,       Gg,       Gg,       Gg,       Gg,       Gg,    Gs^Fp,    Gs^Fp,    Gs^Fp,    Gs^Fp,    Gs^Fp,       Gg,    Gs^Fp,    Gs^Fp,    Gs^Fp,    Gs^Fp,    Gs^Fp,    Gg^Ve,       Hh,    Gs^Fp,    Gs^Fp,    Gs^Fp
    Gs^Fp,    Gs^Fp,       Ch,       Mm,     2 Kh,    Gs^Fp,       Hh,       Gg,       Gg,       Gg,       Gg,       Gg,       Gg,       Gg,    Gg^Vh,       Gg,       Gg,       Gg,       Gg,       Gg,       Gg,       Gg,       Gg,    Gs^Fp,    Gs^Fp,    Gs^Fp,    Gs^Fp,    Gs^Fp,    Gs^Fp,    Gs^Fp,    Gs^Fp,    Gs^Fp,       Hh,       Hh,       Hh,       Hh,       Hh,       Hh
       Rr,       Rr,    Gs^Fp,       Ch,    Gs^Fp,       Rr,       Hh,       Gg,       Gg,       Gg,       Gg,       Gg,       Gg,       Gg,       Gg,       Gg,       Gg,       Gg,       Gg,       Gg,       Gg,       Gg,    Gs^Fp,    Gs^Fp,    Gs^Fp,    Gs^Fp,    Gs^Fp,    Gs^Fp,    Gs^Fp,    Gs^Fp,    Gs^Fp,    Gs^Fp,    Gs^Fp,    Gs^Fp,    Gs^Fp,    Gs^Fp,    Gs^Fp,    Gs^Fp
       Hh,       Hh,       Hh,       Re,       Hh,       Hh,       Gg,       Gg,       Gg,       Gg,       Gg,       Gg,       Gg,       Gg,       Gg,       Gg,       Gg,       Gg,       Gg,       Gg,       Gg,       Gg,    Gs^Fp,    Gs^Fp,       Gg,    Gs^Fp,    Gs^Fp,    Gs^Fp,    Gs^Fp,    Gs^Fp,    Gs^Fp,    Gs^Fp,       Hh,    Gs^Fp,    Gs^Fp,    Gs^Fp,    Gs^Fp,    Gs^Fp
       Gg,       Gg,       Re,       Re,       Re,    Gs^Fp,       Re,       Gg,       Gg,       Gg,       Gg,       Gg,       Gg,       Gg,       Gg,       Gg,    Gg^Vh,       Gg,    Gs^Fp,       Gg,       Gg,       Gg,       Gg,       Gg,    Gs^Fp,    Gs^Fp,    Gs^Fp,    Gs^Fp,    Gs^Fp,    Gs^Fp,       Ce,     1 Ke,       Ce,    Gs^Fp,    Gs^Fp,    Gg^Ve,    Gs^Fp,    Gs^Fp
       Re,       Re,       Re,       Re,       Re,       Re,       Re,       Re,       Gg,       Gg,       Gg,       Gg,       Gg,       Gg,       Gg,       Gg,       Gg,       Gg,       Gg,    Gs^Fp,       Gg,       Gg,    Gs^Fp,    Gs^Fp,    Gs^Fp,    Gs^Fp,    Gs^Fp,    Gs^Fp,       Hh,       Hh,       Ce,       Gg,       Ce,       Hh,    Gs^Fp,    Gs^Fp,    Gs^Fp,    Gs^Fp
       Re,       Re,       Gg,       Re,       Gg,       Gg,       Re,       Re,       Gg,       Gg,       Gg,       Gg,       Gg,       Gg,       Gg,       Gg,       Gg,       Gg,    Gs^Fp,    Gs^Fp,       Re,       Gg,       Hh,       Gg,       Gg,    Gs^Fp,    Gs^Fp,    Gs^Fp,       Hh,    Gs^Fp,    Gs^Fp,    Gs^Fp,       Hh,       Hh,    Gs^Fp,    Gs^Fp,       Hh,       Hh
       Gg,       Gg,       Gg,       Gg,       Gg,       Re,       Re,    Gg^Vh,       Gg,       Gg,       Gg,       Gg,       Gg,       Gg,       Gg,       Gg,       Gg,       Gg,       Re,       Re,       Re,       Re,       Re,       Hh,       Hh,    Gs^Fp,       Hh,    Gs^Fp,       Mm,       Mm,       Mm,       Hh,       Hh,    Gs^Fp,    Gs^Fp,       Hh,       Hh,       Hh
       Gg,       Gg,       Gg,       Gg,       Gg,       Re,       Re,       Re,       Gg,       Gg,       Gg,       Gg,       Gg,       Gg,       Gg,       Gg,       Re,       Re,       Re,       Re,       Gg,       Re,       Re,       Gg,       Hh,       Gg,       Gg,       Mm,       Mm,       Hh,       Mm,       Mm,       Mm,       Mm,       Mm,       Mm,       Mm,       Mm
       Gg,       Gg,       Gg,       Gg,       Gg,       Gg,       Re,       Re,       Re,       Re,       Re,       Gg,       Gg,       Gg,       Re,       Re,       Re,       Re,       Gg,       Gg,       Gg,       Re,       Re,       Re,       Re,       Re,       Re,       Re,       Re,       Re,       Re,       Re,       Re,       Re,       Re,       Mm,       Mm,       Mm
       Gg,       Gg,       Hh,       Gg,       Gg,       Gg,       Gg,       Re,       Re,       Re,       Re,       Re,       Re,       Re,       Re,       Re,       Hh,       Gg,       Gg,       Gg,       Gg,       Gg,       Gg,       Re,       Re,       Re,       Re,       Re,       Re,       Re,       Re,       Re,       Re,       Re,       Re,       Re,       Re,       Re
       Hh,       Hh,       Hh,       Gg,       Gg,       Gg,       Gg,       Gg,       Gg,       Gg,    Gg^Vh,       Re,       Re,       Re,    Gs^Fp,       Hh,       Hh,       Gg,       Gg,       Gg,       Gg,       Gg,    Gs^Fp,    Gg^Vh,       Hh,       Gg,       Hh,       Mm,       Mm,       Mm,       Mm,       Mm,       Mm,       Mm,       Mm,       Re,       Re,       Re
    Gg,    Gg^Vh,       Gg,       Gg,       Gg,       Gg,       Gg,       Gg,       Hh,       Hh,       Hh,       Gg,       Gg,       Gg,       Gg,       Gg,       Gg,       Gg,       Gg,       Hh,       Gg,       Hh,       Gg,    Gs^Fp,    Gs^Fp,       Mm,       Mm,    Gs^Fp,    Gs^Fp,       Hh,       Hh,       Gg,    Gs^Fp,       Gg,    Gs^Fp,       Mm,       Mm,       Mm
       Gg,       Gg,       Gg,       Gg,       Gg,       Gg,       Gg,       Gg,       Gg,       Gg,       Gg,       Gg,       Gg,       Gg,       Gg,       Gg,       Gg,       Gg,       Gg,       Gg,       Gg,       Gg,       Gg,    Gs^Fp,       Gg,       Gg,    Gs^Fp,       Gg,       Gg,       Gg,       Gg,       Gg,       Gg,    Gs^Fp,       Hh,       Hh,    Gs^Fp,    Gs^Fp
    Gs^Fp,    Gs^Fp,    Gs^Fp,       Gg,    Gs^Fp,       Gg,    Gs^Fp,       Gg,    Gs^Fp,       Gg,    Gs^Fp,    Gs^Fp,       Gg,       Gg,    Gs^Fp,       Gg,    Gs^Fp,       Gg,    Gs^Fp,       Gg,       Gg,       Gg,       Gg,       Gg,       Gg,    Gs^Fp,       Gg,    Gs^Fp,       Gg,       Gg,    Gs^Fp,    Gs^Fp,    Gs^Fp,       Gg,       Gg,       Gg,       Gg,       Gg
    Gs^Fp,    Gs^Fp,    Gs^Fp,       Gg,    Gs^Fp,       Gg,    Gs^Fp,       Gg,    Gs^Fp,       Gg,    Gs^Fp,    Gs^Fp,       Gg,       Gg,    Gs^Fp,       Gg,    Gs^Fp,       Gg,    Gs^Fp,       Gg,       Gg,       Gg,       Gg,       Gg,       Gg,    Gs^Fp,       Gg,    Gs^Fp,       Gg,       Gg,    Gs^Fp,    Gs^Fp,    Gs^Fp,       Gg,       Gg,       Gg,       Gg,       Gg
