Re,Gs^Fp,Re,Gs^Fp,Re,Gs^Fp,Gs^Fp,Gs^Fp,Gs^Fp,Gs^Fp,Gs^Fp,Gs^Fp,Gg,Gs^Fp,Gs^Fp,Gs^Fp,Gs^Fp,Gs^Fp,Gs^Fp,Gs^Fp,Gs^Fp,Gg,Gg,Hh,Hh,Gg,Re,Gs^Fp,Gg^Vh,Gs^Fp
Gs^Fp,Gs^Fp,Gs^Fp,Gs^Fp,Gs^Fp,Gs^Fp,Gs^Fp,Gs^Fp,Gs^Fp,Gs^Fp,Gs^Fp,Gs^Fp,Gs^Fp,Gs^Fp,Gs^Fp,Gs^Fp,Gg^Vh,Gs^Fp,Gs^Fp,Gg,Gs^Fp,Gs^Fp,Gs^Fp,Gg,Hh,Ce,Ce,Ce,Gs^Fp,Gs^Fp
Ww,Ww,Gs^Fp,Ww,Gs^Fp,Gs^Fp,Gs^Fp,Gs^Fp,Gs^Fp,Gs^Fp,Gg^Vh,Gs^Fp,Gs^Fp,Gs^Fp,Gs^Fp,Gs^Fp,Gs^Fp,Gs^Fp,Gs^Fp,Gg,Gg,Gs^Fp,Gs^Fp,Gg,Gg,Ce,Kh,Ce,Gs^Fp,Gs^Fp
Ww,Ww,Ww,Ww,Gs^Fp,Gs^Fp,Gs^Fp,Gs^Fp,Gs^Fp,Gs^Fp,Gs^Fp,Gs^Fp,Gs^Fp,Gs^Fp,Gs^Fp,Gs^Fp,Gs^Fp,Gs^Fp,Gs^Fp,Gg,Gg,Gg,Gg,Gg,Gg,Ce,Ce,Ce,Re,Gs^Fp
Ww,Ww,Ww,Ww,Ww,Gs^Fp,Gs^Fp,Gs^Fp,Gs^Fp,Gs^Fp,Gs^Fp,Gs^Fp,Gs^Fp,Gs^Fp,Gs^Fp,Gs^Fp,Gs^Fp,Gs^Fp,Gs^Fp,Gg,Gg,Gg,Gg,Gg,Gg,Gg,Gg,Gs^Fp,Re,Gs^Fp
Ww,Ww,Ww,Ww,Ww,Gg,Gs^Fp,Gs^Fp,Gs^Fp,Gs^Fp,Gs^Fp,Gs^Fp,Gs^Fp,Gs^Fp,Gs^Fp,Gs^Fp,Gs^Fp,Gs^Fp,Gs^Fp,Gs^Fp,Gs^Fp,Gs^Fp,Gs^Fp,Gs^Fp,Gs^Fp,Gs^Fp,Gg,Gg,Re,Gg
Ww,Ww,Ww,Ww,Gg^Vh,Gg,Gs^Fp,Gs^Fp,Gs^Fp,Gs^Fp,Gs^Fp,Gg,Gg,Gg,Gs^Fp,Gs^Fp,Gs^Fp,Gg^Vh,Gs^Fp,Gs^Fp,Gs^Fp,Gs^Fp,Gs^Fp,Gg^Vh,Gs^Fp,Gs^Fp,Gg,Gg,Re,Gg
Gg,Ww,Gg,Gs^Fp,Gg,Gg,Gs^Fp,Gs^Fp,Gs^Fp,Gs^Fp,Gg,Gg,Gg,Gg,Gs^Fp,Gs^Fp,Gs^Fp,Gs^Fp,Gs^Fp,Gs^Fp,Gs^Fp,Gs^Fp,Gs^Fp,Gs^Fp,Gs^Fp,Gs^Fp,Gg,Gg,Re,Gg
Gg,Gg,Gs^Fp,Gs^Fp,Gs^Fp,Gg,Gg,Gs^Fp,Gs^Fp,Gs^Fp,Gg,Gg,Gg,Gg,Gg,Gs^Fp,Gs^Fp,Gs^Fp,Gs^Fp,Gs^Fp,Gs^Fp,Gs^Fp,Gs^Fp,Gs^Fp,Gs^Fp,Gs^Fp,Gg,Gs^Fp,Re,Gs^Fp
Gg,Gg,Gg,Gs^Fp,Gs^Fp,Gs^Fp,Gs^Fp,Gg,Gs^Fp,Gg,Gg,Gg,Gg,Gg,Gg,Gs^Fp,Gs^Fp,Gs^Fp,1 Kh,Gs^Fp,Gs^Fp,Gs^Fp,Gs^Fp,Gs^Fp,Gs^Fp,Gs^Fp,Gs^Fp,Gs^Fp,Re,Re
Gs^Fp,Gg,Gs^Fp,Gs^Fp,Gs^Fp,Gs^Fp,Gs^Fp,Gg,Gg,Gg,Gg,Gg,Gg,Gg,Gg,Gg,Gs^Fp,Gs^Fp,Gg,Gs^Fp,Gs^Fp,Gs^Fp,Gs^Fp,Gs^Fp,Gs^Fp,Gs^Fp,Gs^Fp,Gs^Fp,Gs^Fp,Gs^Fp
Gs^Fp,Gg,Gs^Fp,Gs^Fp,Gs^Fp,Gg^Vh,Gs^Fp,Gg,Gs^Fp,Gs^Fp,Gg,Gg,Gg,Gg,Gg,Gg,Gg,Gg,Gg,Gg,Gs^Fp,Gs^Fp,Gs^Fp,Gs^Fp,Gs^Fp,Gs^Fp,Gs^Fp,Gs^Fp,Gs^Fp,Gs^Fp
Gs^Fp,Gs^Fp,Gs^Fp,Gs^Fp,Gs^Fp,Gs^Fp,Gs^Fp,Gs^Fp,Gs^Fp,Gs^Fp,Gg,Gg,Gg,Gg,Gg,Gg,Gg,Gg,Gg,Gs^Fp,Gg,Gs^Fp,Gs^Fp,Gs^Fp,Gs^Fp,Gs^Fp,Gs^Fp,Gs^Fp,Gg,Gs^Fp
Gs^Fp,Gs^Fp,Gs^Fp,Gs^Fp,Gs^Fp,Gs^Fp,Gs^Fp,Gs^Fp,Gs^Fp,Gs^Fp,Gg,Gg,Gg,Gg,Gs^Fp,Gs^Fp,Gs^Fp,Gs^Fp,Gs^Fp,Gs^Fp,Gs^Fp,Gs^Fp,Gs^Fp,Gs^Fp,Gs^Fp,Gs^Fp,Gs^Fp,Gs^Fp,Gg,Gg
Gs^Fp,Gs^Fp,Gs^Fp,Gs^Fp,Gs^Fp,Gs^Fp,Gs^Fp,Gs^Fp,Gs^Fp,Gs^Fp,Gg,Gg,Gg,Gs^Fp,Gs^Fp,Gs^Fp,Ss,Ss,Ss,Gs^Fp,Gs^Fp,Gs^Fp,Gs^Fp,Gs^Fp,Gs^Fp,Gs^Fp,Gs^Fp,Gg,Gg,Gg
Gs^Fp,Gs^Fp,Gs^Fp,Gs^Fp,Gs^Fp,Gs^Fp,Gs^Fp,Gs^Fp,Gs^Fp,Gs^Fp,Gg,Gg,Gg,Gs^Fp,Gs^Fp,Gs^Fp,Gs^Fp,Gs^Fp,Ss,Ss,Ss,Gs^Fp,Gs^Fp,Gs^Fp,Gs^Fp,Gs^Fp,Gs^Fp,Gs^Fp,Gg,Gg
Gs^Fp,Gs^Fp,Gs^Fp,Gs^Fp,Gs^Fp,Gs^Fp,Gs^Fp,Gs^Fp,Gs^Fp,Gg,Gg,Gg,Gg,Gg,Gs^Fp,Ss,Ss,Gs^Fp,Ss,Ss,Ss,Ss,Ss,Gs^Fp,Gs^Fp,Gs^Fp,Gs^Fp,Gs^Fp,Gs^Fp,Gg
Gs^Fp,Gs^Fp,Gs^Fp,Gs^Fp,Gs^Fp,Gs^Fp,Gs^Fp,Gs^Fp,Gs^Fp,Gg,Gg,Gg,Gg,Gg,Gs^Fp,Ss,Ss,Gs^Fp,Ss,Ss^Vhs,Ss,Ss,Ss,Gs^Fp,Gs^Fp,Gs^Fp,Gs^Fp,Gs^Fp,Gs^Fp,Gs^Fp
Gs^Fp,Gs^Fp,Gs^Fp,Gs^Fp,Gs^Fp,Gg^Vh,Gs^Fp,Gs^Fp,Gs^Fp,Gg,Gg,Gg,Gg,Gg,Gs^Fp,Gs^Fp,Ss,Ss,Ss,Ss,Ss,Ss,Ss,Gs^Fp,Gs^Fp,Gs^Fp,Gs^Fp,Gs^Fp,Gg,Gs^Fp
Gs^Fp,Gg,Gg,Gs^Fp,Gs^Fp,Gs^Fp,Gs^Fp,Gs^Fp,Gg,Gg,Gg,Gg,Gg,Gg,Gg,Gg,Gs^Fp,Ss,Ss,Ss,Ss,Ss,Ss,Ss,Ss,Gg,Gg,Gg,Gg,Gg
Gg,Gg,Gs^Fp,Gs^Fp,Gs^Fp,Gs^Fp,Gs^Fp,Gs^Fp,Gs^Fp,Gg,Gg,Gg,Gg,Gg,Gg,Gg,Gg,Gs^Fp,Ss,Ss,Ss,Ss,Ss^Vhs,Ss,Ss,Gg,Gg,Gg,Gg,Gg
Gg,Gs^Fp,Gs^Fp,Gs^Fp,Gs^Fp,Gs^Fp,Gs^Fp,Gs^Fp,Gg,Gg,Gg,Gg,Gg,Gg,Gg,Gg,Gg,Ss,Ss,Ss,Ss,Ss,Ss,Ss,Gg,Gg,Gg,Gg,Gg,Gg
Gg,Gs^Fp,Gs^Fp,Gs^Fp,Gg^Vh,Gs^Fp,Gs^Fp,Gg,Gg,Gg,Gg,Gg,Gg,Gg,Gg,Gg,Gs^Fp,Gs^Fp,Ss,Ss,Ss,Ss,Ss,Ss,Gg,Gg,Gg,Gg,Gg,Gg
Gg,Gs^Fp,Gs^Fp,Gs^Fp,Gs^Fp,Gs^Fp,Gs^Fp,Gs^Fp,Gg,Gs^Fp,Gs^Fp,Gs^Fp,Gg,Gg,Gg,Gs^Fp,Gs^Fp,Gs^Fp,Ss,Ss,Ss,Ss,Ss,Ss,Gg,Gg,Gg,Gg,Gg,Gg
Gg,Gs^Fp,Gs^Fp,Gs^Fp,Gs^Fp,Gs^Fp,Gs^Fp,Gs^Fp,Gs^Fp,Gs^Fp,Gg^Vh,Gs^Fp,Gg,Gg,Gg,Gg,Gs^Fp,Ss,Ss,Ss,Ss,Ss,Ss,Ss,Gg,Gg,Gg,Gs^Fp,Gs^Fp,Gs^Fp
Gg,Ce,Ce,Ce,Gs^Fp,Gg^Vh,Gs^Fp,Gs^Fp,Gs^Fp,Gs^Fp,Gs^Fp,Gs^Fp,Gg,Gg,Gg,Gg,Gg,Ss,Ss,Ss^Vhs,Ss,Ss,Ss,Ss,Ss,Ss,Gg,Gs^Fp,Gs^Fp,Gs^Fp
Gg,Ce,2 Kh,Ce,Gs^Fp,Gs^Fp,Gs^Fp,Gs^Fp,Gs^Fp,Gs^Fp,Gs^Fp,Gs^Fp,Gg,Gg,Gg,Gg,Ss,Ss,Ss,Ss,Ss,Ss,Ss,Ss,Ss,Ss,Gg,Gs^Fp,Gs^Fp,Gs^Fp
Gg,Ce,Ce,Ce,Gs^Fp,Gs^Fp,Gs^Fp,Gs^Fp,Gs^Fp,Ce,Ce,Ce,Gg,Gg,Gg,Gg,Ss,Ss,Ss,Ss,Ss,Ss,Ss,Ss^Vhs,Ss,Ss,Gg,Gg,Gs^Fp,Gs^Fp
Gs^Fp,Gs^Fp,Gs^Fp,Gs^Fp,Gs^Fp,Gs^Fp,Gs^Fp,Gs^Fp,Gs^Fp,Ce,3 Kh,Ce,Gg,Hh,Hh,Ss,Ss,Ss,Ss,Ss,Ss,Ss,Ss,Ss,Ss,Gg,Gg,Gg,Gg,Gg
Gs^Fp,Gs^Fp,Gs^Fp,Gs^Fp,Gs^Fp,Gs^Fp,Gs^Fp,Gg^Vh,Gs^Fp,Ce,Ce,Ce,Gg,Gg,Hh,Ss,Ss,Ss,Ss,Ss,Ss,Ss,Ss,Ss,Ss,Gg,Gg,Gg,Gg,Gs^Fp