border_size=1
usage=map

       Mm,       Mm,       Mm,       Mm,       Mm,       Hh,       Hh,    Gs^Fp,       Hh,       Hh,       Mm,       Mm,       Hh,       Hh,       Gg,       Re,       Ch,       Ch,       Ch,       Gg,       Gg,       Hh,       Hh,       Mm,       Hh,       Hh,    Gs^Fp,    Gs^Fp,       Hh,       Hh,       Hh,       Ss,       Ss,       Ww,       Ww,       Wo,       Wo,       Wo,       Wo,       Wo
       Mm,       Mm,       Mm,       Mm,       Mm,       Hh,       Hh,    Gs^Fp,       Hh,       Hh,       Mm,       Mm,       Hh,       Hh,       Gg,       Re,       Ch,       Ch,       Ch,       Gg,       Gg,       Hh,       Hh,       Mm,       Hh,       Hh,    Gs^Fp,    Gs^Fp,       Hh,       Hh,       Hh,       Ss,       Ss,       Ww,       Ww,       Wo,       Wo,       Wo,       Wo,       Wo
       Mm,       Mm,       Hh,       Mm,       Mm,       Mm,       Mm,    Gs^Fp,    Gs^Fp,       Hh,       Mm,       Hh,       Hh,       Gg,       Gg,       Re,       Ch,     1 Kh,       Ch,       Hh,       Hh,       Hh,       Mm,       Mm,       Hh,    Gs^Fp,       Hh,    Gs^Fp,    Gs^Fp,    Gs^Fp,    Gg^Vh,    Gs^Fp,       Ss,       Ss,       Ww,       Ww,       Wo,       Wo,       Wo,       Wo
       Mm,       Mm,    Gg^Ve,       Hh,       Hh,       Mm,       Mm,       Hh,    Gs^Fp,       Hh,       Hh,       Mm,       Hh,       Hh,       Gg,       Re,       Gg,       Ch,       Hh,       Hh,       Hh,    Gg^Ve,       Mm,       Mm,       Hh,       Hh,    Gs^Fp,    Gs^Fp,       Ss,    Gs^Fp,       Ss,       Re,   Ww^Bw\,       Ww,       Ss,       Ww,       Ww,       Wo,       Wo,       Wo
       Hh,       Hh,       Ss,    Gs^Fp,       Ss,       Mm,       Ss,       Hh,       Ss,    Gs^Fp,       Hh,       Mm,       Mm,       Hh,       Gg,       Re,       Gg,       Hh,       Hh,       Hh,       Mm,       Mm,       Hh,       Hh,    Gs^Fp,       Hh,    Gs^Fp,       Ss,       Ss,       Ww,    Gs^Fp,       Ss,       Re,       Re,    Gs^Fp,       Ss,       Ss,    Ww^Vm,       Ww,       Ww
       Hh,       Hh,       Wo,       Ww,       Wo,       Ww,       Wo,       Ww,    Gg^Ve,       Ss,       Ww,       Hh,       Mm,       Mm,       Ch,       Re,       Ch,       Mm,       Mm,       Mm,       Mm,       Hh,       Hh,    Gs^Fp,    Gs^Fp,    Gs^Fp,       Ss,       Ss,       Ss,    Gs^Fp,       Hh,    Gs^Fp,    Gs^Fp,       Re,    Gs^Fp,       Hh,       Hh,       Ss,       Ss,       Ss
       Ww,       Ww,       Ww,   Ww^Bw\,       Re,       Wo,    Gs^Fp,       Re,    Gs^Fp,       Ss,       Wo,       Ww,       Hh,       Hh,       Gg,       Re,       Gg,       Mm,    Gs^Fp,       Hh,       Hh,       Hh,    Gs^Fp,       Hh,    Gs^Fp,    Gs^Fp,       Ss,       Ss,       Hh,    Gs^Fp,       Hh,    Gs^Fp,    Gs^Fp,       Re,       Re,       Hh,       Hh,       Ss,       Ss,       Ss
       Hh,       Hh,    Gs^Fp,    Gs^Fp,    Gs^Fp,       Re,       Re,       Re,       Hh,       Ss,       Wo,       Ww,       Hh,       Hh,       Re,       Re,       Ss,       Ss,       Ss,       Hh,    Gs^Fp,    Gs^Fp,    Gs^Fp,    Gg^Ve,    Gs^Fp,    Gs^Fp,    Gs^Fp,    Gs^Fp,       Hh,       Hh,       Mm,    Gs^Fp,    Gs^Fp,    Gs^Fp,    Gg^Vh,    Gs^Fp,    Gs^Fp,       Hh,       Hh,       Hh
       Hh,       Hh,       Hh,    Gs^Fp,       Hh,       Hh,       Mm,       Mm,       Mm,       Ss,       Wo,       Ww,       Hh,    Gs^Fp,       Re,       Ss,   Ss^Vhs,       Ss,    Gs^Fp,    Gs^Fp,       Hh,    Gs^Fp,    Gs^Fp,    Gs^Fp,    Gs^Fp,    Gs^Fp,       Ss,    Gs^Fp,    Gs^Fp,       Hh,       Mm,    Gs^Fp,       Re,       Re,    Gs^Fp,    Gs^Fp,       Hh,    Gs^Fp,    Gs^Fp,    Gs^Fp
       Hh,       Hh,       Mm,       Mm,       Mm,       Mm,       Mm,       Hh,       Hh,       Hh,       Wo,       Ww,       Hh,    Gs^Fp,       Re,       Ss,       Ss,       Ss,    Gs^Fp,    Gs^Fp,       Hh,    Gs^Fp,    Gs^Fp,    Gs^Fp,       Ss,       Ss,   Ss^Vhs,       Ss,    Gs^Fp,       Hh,       Mm,    Gs^Fp,       Re,    Gs^Fp,       Hh,       Hh,    Gs^Fp,    Gs^Fp,       Hh,       Hh
       Mm,       Mm,    Gs^Fp,       Hh,       Hh,       Mm,       Hh,       Hh,    Gs^Fp,       Ss,       Wo,       Ww,       Re,       Re,       Re,       Ss,       Re,    Gs^Fp,    Gs^Fp,       Hh,    Gs^Fp,    Gs^Fp,       Ss,       Ss,       Ss,       Ss,       Ss,       Ss,       Re,       Hh,       Re,    Gs^Fp,       Re,    Gs^Fp,       Ch,    Gs^Fp,    Gs^Fp,       Hh,       Hh,       Hh
    Gs^Fp,    Gs^Fp,    Gs^Fp,    Gs^Fp,       Hh,       Hh,    Gs^Fp,    Gs^Fp,       Hh,       Gg,   Ww^Bw/,   Ww^Bw/,       Hh,    Gs^Fp,    Gs^Fp,       Re,    Gs^Fp,       Re,       Re,       Hh,    Gs^Fp,    Gs^Fp,    Gs^Fp,       Ss,       Ss,       Ss,   Ww^Bw/,   Ww^Bw/,       Ss,       Re,    Gs^Fp,       Re,       Re,       Ch,     4 Kh,       Ch,    Gs^Fp,    Gs^Fp,       Hh,       Hh
       Gg,       Gg,       Gg,    Gs^Fp,    Gs^Fp,       Hh,    Gg^Ve,       Hh,       Re,       Re,    Gs^Fp,       Ww,       Ss,    Gs^Fp,       Hh,    Gs^Fp,    Gs^Fp,       Hh,    Gs^Fp,       Re,       Re,    Gs^Fp,       Re,    Gs^Fp,       Re,       Re,       Ss,       Ss,       Ww,       Ww,    Gs^Fp,       Hh,       Hh,       Ch,       Ch,       Ch,    Gs^Fp,    Gs^Fp,       Hh,       Hh
    Gg,    Gg^Ve,       Re,    Gs^Fp,       Gg,       Gg,       Re,       Re,       Gg,       Re,       Re,    Gs^Fp,       Ss,       Ss,    Gs^Fp,    Gs^Fp,    Gs^Fp,       Hh,    Gg^Ve,    Gs^Fp,       Hh,       Re,       Hh,       Re,    Gs^Fp,       Ww,       Ww,       Ss,    Gs^Fp,       Ww,       Hh,    Gs^Fp,       Hh,       Hh,       Re,    Gs^Fp,       Hh,       Hh,       Hh,       Hh
       Hh,       Hh,       Re,       Gg,       Re,       Re,       Hh,       Hh,       Hh,       Gg,       Gg,       Re,       Hh,       Ss,    Gs^Fp,       Hh,       Hh,    Gs^Fp,    Gs^Fp,       Hh,       Hh,       Re,       Hh,    Gs^Fp,    Gs^Fp,    Gs^Fp,       Wo,   Ww^Bw\,       Hh,    Gs^Fp,       Hh,    Gs^Fp,    Gs^Fp,       Hh,       Re,       Hh,       Hh,       Hh,    Gs^Fp,    Gs^Fp
       Re,       Re,       Hh,       Re,       Gg,       Hh,       Mm,       Mm,       Hh,       Hh,    Gs^Fp,       Re,       Gg,       Ss,       Hh,    Gs^Fp,       Hh,    Gs^Fp,    Gs^Fp,       Hh,       Ss,       Re,   Ww^Bw\,    Gs^Fp,    Gs^Fp,    Gs^Fp,       Ss,    Gs^Fp,    Gs^Fp,       Hh,    Gs^Fp,    Gg^Vh,    Gs^Fp,       Hh,       Re,       Hh,       Hh,       Hh,       Wo,       Wo
       Hh,       Hh,       Re,       Re,       Hh,       Hh,       Hh,       Hh,    Gs^Fp,       Hh,       Hh,       Re,   Ww^Bw\,       Ss,       Hh,    Gs^Fp,    Gs^Fp,    Gs^Fp,       Ss,    Gs^Fp,       Ss,       Ss,       Ww,       Gg,       Wo,       Ww,       Ww,       Ss,       Ss,    Gs^Fp,       Ss,    Gs^Fp,       Hh,       Hh,       Re,    Gs^Fp,    Gs^Fp,       Hh,    Gs^Fp,    Gs^Fp
    Gs^Fp,    Gs^Fp,       Re,       Hh,    Gs^Fp,    Gs^Fp,    Gs^Fp,    Gs^Fp,       Hh,    Gs^Fp,       Ss,       Ww,       Re,       Gg,       Hh,    Gg^Ve,       Gg,       Ss,       Ww,       Ss,       Ww,       Ww,       Wo,   Ww^Bw|,       Wo,       Wo,       Wo,       Wo,       Wo,       Ss,       Ww,       Ss,       Ss,       Hh,       Ss,       Re,    Gs^Fp,       Hh,       Hh,       Hh
       Hh,       Hh,       Re,    Gs^Fp,    Gs^Fp,       Hh,       Mm,    Gs^Fp,    Gs^Fp,       Ss,       Ss,       Gg,       Re,       Gg,       Re,       Hh,       Ww,       Ww,       Wo,       Wo,       Wo,       Wo,       Wo,   Ww^Bw|,       Ss,       Wo,       Ww,       Wo,       Wo,       Wo,       Wo,       Wo,       Wo,       Ww,       Wo,   Ww^Bw|,       Wo,       Ss,       Ss,       Ss
       Hh,       Hh,       Ch,    Gs^Fp,    Gs^Fp,       Hh,       Mm,       Hh,    Gs^Fp,       Ss,    Gs^Fp,       Gg,       Hh,       Re,       Ww,   Ww^Bw\,   Ww^Bw\,       Wo,       Wo,       Wo,       Ch,       Kh,       Ch,   Ww^Bw|,       Ss,       Ss,       Ss,       Ww,       Ss,       Ww,    Gs^Fp,       Ww,       Ww,       Wo,       Ww,   Ww^Bw|,       Wo,       Wo,       Wo,       Wo
       Ch,       Ch,     2 Kh,       Ch,       Re,       Mm,       Mm,       Hh,       Ss,       Ww,       Ww,       Ss,       Ww,       Ww,       Wo,       Wo,       Ww,   Ww^Bw\,   Ww^Bw\,       Ww,       Ch,       Ch,    Gs^Fp,       Re,    Gs^Fp,    Gs^Fp,    Gs^Fp,       Ss,    Gs^Fp,       Ss,       Hh,    Gs^Fp,    Gs^Fp,       Ss,       Re,   Ww^Bw|,       Ww,       Wo,       Ss,       Ss
       Ch,       Ch,       Ch,       Ch,       Re,       Hh,    Gs^Fp,    Gs^Fp,       Ww,       Ww,       Wo,       Ww,       Wo,       Wo,       Ww,       Ww,    Gs^Fp,    Gs^Fp,    Gs^Fp,       Re,       Re,       Hh,       Hh,       Re,       Re,    Gs^Fp,       Re,    Gs^Fp,       Re,       Re,       Re,       Hh,    Gs^Fp,       Re,       Hh,       Re,       Hh,       Ss,    Gs^Fp,    Gs^Fp
       Ww,       Ww,       Wo,       Hh,       Re,    Gs^Fp,       Ww,       Ww,       Wo,       Wo,       Wo,       Wo,    Gs^Fp,       Ww,    Gs^Fp,    Gs^Fp,       Re,    Gs^Fp,    Gs^Fp,       Hh,       Hh,       Re,       Re,       Hh,       Re,       Re,       Hh,       Re,       Mm,       Ww,       Mm,       Re,       Re,       Re,       Hh,       Hh,    Gs^Fp,    Gs^Fp,       Hh,       Hh
       Wo,       Wo,    Ww^Vm,       Ss,   Ww^Bw|,       Ss,       Wo,       Wo,       Wo,       Wo,       Ww,       Ww,    Gs^Fp,    Gs^Fp,       Re,       Re,       Hh,       Re,       Re,       Mm,       Mm,       Hh,       Re,       Gg,       Re,       Hh,       Mm,       Mm,       Mm,       Mm,    Gg^Ve,    Gs^Fp,       Re,       Hh,    Gs^Fp,    Gs^Fp,       Hh,    Gg^Vh,       Hh,       Hh
       Ww,       Ww,       Ss,       Ww,   Ww^Bw|,       Wo,       Wo,       Wo,       Ww,       Ww,    Gs^Fp,    Gs^Fp,    Gs^Fp,       Re,       Hh,    Gs^Fp,    Gs^Fp,       Hh,       Hh,       Re,       Hh,       Mm,       Hh,       Re,       Hh,       Hh,       Hh,       Mm,       Ss,       Mm,       Ss,       Ss,   Ww^Bw|,       Ss,       Ss,       Hh,       Mm,       Hh,       Mm,       Mm
    Gs^Fp,    Gs^Fp,    Gs^Fp,       Ww,   Ww^Bw|,       Wo,       Ww,    Ww^Vm,       Ss,    Gs^Fp,    Gs^Fp,    Gs^Fp,       Re,       Re,    Gs^Fp,    Gg^Ve,       Mm,       Hh,    Gs^Fp,       Re,       Re,       Gg,    Gs^Fp,       Re,       Re,       Gg,       Hh,       Mm,       Mm,       Ss,       Ss,       Ss,   Ww^Bw|,       Ss,       Ss,       Ss,       Hh,       Mm,       Mm,       Mm
       Mm,       Mm,       Mm,    Gs^Fp,    Gs^Fp,       Re,       Re,       Ss,       Re,       Re,       Re,       Re,    Gs^Fp,    Gs^Fp,    Gs^Fp,       Mm,       Hh,       Hh,       Ss,    Gs^Fp,       Hh,       Re,       Re,       Hh,       Re,       Gg,       Hh,       Hh,       Mm,       Mm,       Mm,       Ss,       Re,       Ss,       Hh,       Ss,       Hh,       Mm,       Mm,       Mm
       Mm,       Mm,       Mm,    Gg^Ve,    Gs^Fp,       Ss,    Gs^Fp,       Re,       Mm,       Mm,       Mm,       Mm,       Mm,    Gs^Fp,       Hh,       Hh,       Ss,       Ss,       Ss,       Ss,       Hh,       Hh,       Hh,       Re,       Gg,       Re,       Gg,       Hh,       Hh,       Mm,       Mm,    Gs^Fp,    Gs^Fp,       Re,       Re,    Gs^Fp,    Gs^Fp,       Hh,       Hh,       Hh
       Mm,       Mm,       Mm,       Mm,       Hh,       Ss,       Ss,       Re,       Ss,       Mm,       Hh,       Mm,       Mm,       Hh,    Gs^Fp,    Gs^Fp,       Ss,       Ss,    Gs^Fp,       Ss,       Ss,    Gs^Fp,    Gs^Fp,    Gs^Fp,       Gg,       Re,       Ww,       Ww,       Wo,    Gs^Fp,       Mm,       Hh,       Hh,    Gs^Fp,       Re,    Gs^Fp,    Gs^Fp,    Gs^Fp,    Gs^Fp,    Gs^Fp
       Mm,       Mm,       Hh,       Hh,       Mm,       Hh,       Ss,       Re,       Ss,    Gs^Fp,    Gg^Ve,       Hh,       Hh,       Mm,       Hh,       Hh,       Hh,       Ss,       Ss,       Ss,       Ss,    Gs^Fp,    Gs^Fp,    Gg^Ve,       Re,       Re,       Ww,       Wo,       Wo,    Gs^Fp,       Mm,       Hh,    Gs^Fp,    Gs^Fp,       Re,    Gs^Fp,       Hh,       Hh,       Hh,       Hh
       Hh,       Hh,    Gs^Fp,    Gs^Fp,    Gs^Fp,    Gs^Fp,    Gs^Fp,       Re,       Re,    Gs^Fp,    Gs^Fp,    Gs^Fp,       Hh,       Hh,    Gs^Fp,    Gs^Fp,    Gs^Fp,       Ss,       Ss,       Ss,    Gs^Fp,    Gs^Fp,       Hh,       Gg,       Re,       Gg,       Hh,       Wo,    Gs^Fp,    Gs^Fp,       Gg,    Gs^Fp,       Re,       Re,    Gs^Fp,    Gs^Fp,       Hh,    Gg^Vh,       Mm,       Mm
       Hh,       Hh,       Hh,    Gs^Fp,       Hh,       Hh,       Hh,    Gs^Fp,       Re,    Gs^Fp,       Re,    Gs^Fp,    Gs^Fp,    Gs^Fp,       Hh,    Gs^Fp,    Gs^Fp,    Gs^Fp,    Gs^Fp,       Wo,       Ww,    Gs^Fp,       Hh,    Gs^Fp,       Re,       Wo,       Hh,    Gs^Fp,       Hh,       Gg,       Hh,       Re,       Ch,       Ch,       Ch,       Hh,       Mm,       Mm,       Mm,       Mm
       Mm,       Mm,       Mm,       Mm,       Mm,       Mm,       Mm,       Hh,       Hh,       Re,       Re,       Re,       Re,       Gg,       Hh,       Hh,       Hh,    Gs^Fp,    Gs^Fp,       Ss,       Ww,       Ww,       Hh,    Gs^Fp,    Gs^Fp,       Re,       Re,       Hh,       Re,       Re,       Re,       Re,       Ch,     3 Kh,       Ch,       Hh,       Hh,       Hh,    Gs^Fp,    Gs^Fp
       Xu,       Xu,       Xu,       Xu,       Xu,       Xu,       Xu,       Mm,       Mm,       Hh,       Hh,    Gs^Fp,       Rr,       Re,       Re,       Gg,       Gg,       Gg,       Gg,    Gs^Fp,       Hh,       Ww,       Ww,       Ss,    Gs^Fp,    Gs^Fp,       Re,       Re,       Gg,       Gg,    Gs^Fp,    Gs^Fp,       Hh,       Ch,       Hh,       Hh,       Ww,    Gs^Fp,       Wo,       Wo
    Uu,    Uu^Vu,       Uu,       Uu,       Uu,       Uu,       Uu,       Xu,       Xu,       Mm,       Gg,       Rr,    Gs^Fp,       Re,       Gg,       Re,       Re,       Re,       Re,       Re,       Re,       Hh,       Ss,       Ww,       Re,       Re,       Hh,    Gs^Fp,    Gs^Fp,       Gg,    Gs^Fp,    Gs^Fp,       Ww,       Ww,       Ww,       Ww,       Hh,       Ww,    Gs^Fp,    Gs^Fp
       Xu,       Xu,       Xu,       Xu,       Xu,       Xu,       Xu,       Uu,       Uu,       Xu,       Gg,       Hh,       Mm,       Mm,       Hh,       Gg,       Gg,       Gg,    Gs^Fp,    Gs^Fp,    Gs^Fp,       Re,       Re,   Ww^Bw/,       Ww,       Hh,       Mm,       Mm,    Gs^Fp,       Gg,   Ww^Bw\,       Ww,       Hh,       Hh,       Mm,       Hh,       Hh,    Gs^Fp,    Gs^Fp,    Gs^Fp
    Uu,    Uu^Vu,       Uu,       Uu,       Uu,       Uu,       Uu,       Uu,       Xu,       Uu,       Xu,       Mm,       Mm,       Hh,       Ch,       Ch,       Ch,    Gs^Fp,       Hh,       Mm,       Mm,       Hh,       Hh,       Ss,       Ww,       Hh,       Hh,    Gs^Fp,       Hh,       Ww,       Ww,       Hh,       Mm,       Mm,       Hh,       Mm,       Mm,    Gs^Fp,    Gs^Fp,    Gs^Fp
       Xu,       Xu,       Xu,       Xu,       Uu,       Uu,       Uu,       Xu,       Xu,       Uu,       Uu,       Xu,       Mm,       Hh,       Ch,     5 Kh,       Ch,       Hh,       Mm,       Mm,    Gg^Ve,       Mm,       Hh,       Hh,       Hh,       Ww,       Wo,       Gg,       Ww,       Ww,       Hh,       Hh,       Mm,       Hh,       Gg,       Hh,       Mm,       Hh,       Hh,       Hh
       Xu,       Xu,       Uu,       Uu,       Xu,       Xu,       Xu,       Uu,    Uu^Vu,       Xu,       Uu,       Xu,       Mm,       Hh,       Hh,       Ch,       Hh,       Hh,       Hh,       Mm,       Mm,       Mm,       Hh,    Gs^Fp,    Gs^Fp,       Ww,       Wo,       Wo,       Ww,       Hh,       Mm,       Mm,       Hh,       Gg,    Gg^Vh,       Gg,       Hh,       Mm,       Mm,       Mm
    Uu,    Uu^Vu,       Uu,       Uu,    Uu^Vu,       Xu,       Xu,       Xu,       Xu,       Xu,       Uu,       Xu,       Mm,       Hh,    Gs^Fp,       Hh,    Gs^Fp,    Gs^Fp,    Gs^Fp,       Hh,       Mm,       Hh,    Gs^Fp,    Gs^Fp,    Gs^Fp,    Gs^Fp,       Hh,       Wo,       Wo,       Hh,       Mm,       Mm,       Hh,       Gg,       Hh,       Gg,       Hh,       Hh,       Hh,       Hh
    Uu,    Uu,       Uu,       Uu,    Uu,       Xu,       Xu,       Xu,       Xu,       Xu,       Uu,       Xu,       Mm,       Hh,    Gs^Fp,       Hh,    Gs^Fp,    Gs^Fp,    Gs^Fp,       Hh,       Mm,       Hh,    Gs^Fp,    Gs^Fp,    Gs^Fp,    Gs^Fp,       Hh,       Wo,       Wo,       Hh,       Mm,       Mm,       Hh,       Gg,       Hh,       Gg,       Hh,       Hh,       Hh,       Hh
