Mm,Mm,Mm,Mm,Mm,Mm,Mm,Mm,Mm,Mm,Hh,Ds,Ds,Ds,Ww,Ww,Wo,Wo,Wo,Wo,Wo,Ww,Ww,Ds,Hh,Hh,Mm,Mm,Mm,Mm,Mm,Mm,Mm,Mm,Mm,Mm,Mm,Mm,Mm,Mm,Mm,Mm,Mm,Mm,Mm,Mm,Mm,Mm,Mm,Hh,Hh,Gs^Fp,Gs^Fp,Gs^Fp,Gs^Fp,Gs^Fp,Gs^Fp,Gs^Fp,Gs^Fp,Gs^Fp,Gs^Fp,Gs^Fp,Gs^Fp,Ds,Ww,Ww,Ww,Ww,Ww,Ww
Mm,Mm,Mm,Gg,Mm,Mm,Mm,Mm,Mm,Hh,Hh,Hh,Hh,Ds,Ww,Ww,Wo,Wo,Wo,Wo,Ww,Ww,Ds,Ds,Hh,Hh,Mm,Mm,Mm,Mm,Mm,Mm,Mm,Mm,Hh,Hh,Hh,Hh,Mm,Mm,Mm,Mm,Mm,Mm,Mm,Mm,Mm,Mm,Hh,Hh,Gs^Fp,Gs^Fp,Gs^Fp,Gs^Fp,Gs^Fp,Gs^Fp,Gs^Fp,Gs^Fp,Gs^Fp,Gg,Gg,Gg,Ds,Ds,Ww,Ww,Ww,Ww,Ww,Ww
Mm,Mm,Gg,Gg,Ds,Mm,Mm,Mm,Mm,Hh,Hh,Hh,Hh,Ds,Ww,Ww,Wo,Wo,Wo,Wo,Ww,Ww,Ds,Hh,Hh,Hh,Hh,Mm,Mm,Mm,Mm,Mm,Mm,Hh,Ww,Ww,Ww,Ww,Hh,Mm,Mm,Mm,Mm,Mm,Mm,Mm,Hh,Hh,Hh,Hh,Gs^Fp,Gs^Fp,Gs^Fp,Gs^Fp,Gs^Fp,Gs^Fp,Gs^Fp,Gg,Gg,Gg,Gg,Ds,Ds,Ww,Ww,Ww,Ww,Ww,Ww,Ww
Mm,Mm,Gg,Ds,Ds,Ds,Ds,Mm,Mm,Mm,Hh,Ds,Ds,Ds,Ww,Ww,Wo,Wo,Wo,Wo,Ww,Ww,Ds,Hh,Hh,Mm,Mm,Mm,Ds,Ds,Mm,Mm,Hh,Ww^Vm,Ww,Chr,Chr,Ww,Hh,Mm,Mm,Mm,Mm,Mm,Mm,Hh,Hh,Hh,Hh,Gg,Gs^Fp,Gs^Fp,Gs^Fp,Gs^Fp,Gs^Fp,Gs^Fp,Gs^Fp,Ds,Ds,Ds,Ds,Ds,Ww,Ww,Ww,Ww,Ww,Ww,Ww,Ww
Mm,Mm,Mm,Mm,Mm,Mm,Ds,Ds,Ds,Mm,Mm,Hh,Ds,Ww,Ww,Wo,Wo,Wo,Wo,Wo,Ww,Ww,Ds,Ds,Hh,Hh,Ds,Ds,Ds,Ds,Ds,Ds,Ds,Ww,Ww,Kh,Chr,Ww,Hh,Mm,Mm,Mm,Mm,Mm,Mm,Mm,Mm,Hh,Hh,Gs^Fp,Gs^Fp,Gs^Fp,Gs^Fp,Gs^Fp,Gs^Fp,Gs^Fp,Gs^Fp,Ds,Ww,Ww,Ww,Ww,Ww,Ww,Ww,Ww,Ww,Ww,Ww,Ww
Mm,Mm,Mm,Mm,Mm,Mm,Mm,Mm,Ds,Ds,Ds,Ds,Ds,Ww,Ww,Wo,Wo,Wo,Wo,Wo,Ww,Ww,Ds,Ds,Ds,Ds,Ds,Ds,Ds,Mm,Mm,Mm,Hh,Ww^Vm,Ww,Chr,Ww,Ww,Hh,Mm,Mm,Mm,Mm,Mm,Mm,Hh,Hh,Hh,Gs^Fp,Gs^Fp,Gs^Fp,Gs^Fp,Gs^Fp,Gs^Fp,Gs^Fp,Ds,Ds,Ds,Ww,Ww,Ww,Ww,Ww,Ww^Vm,Ww,Ww,Ww,Ww,Ww,Ww
Mm,Mm,Mm,Mm,Mm,Mm,Mm,Mm,Mm,Mm,Hh,Hh,Ds,Ww,Ww,Wo,Wo,Wo,Wo,Ww,Ww,Ds,Ds,Hh,Hh,Hh,Hh,Mm,Mm,Mm,Mm,Mm,Mm,Hh,Ww,Ww,Ww,Hh,Mm,Mm,Mm,Mm,Mm,Hh,Hh,Hh,Hh,Hh,Gs^Fp,Gs^Fp,Gs^Fp,Gs^Fp,Gs^Fp,Gg,Ds,Ds,Ww,Ww,Ww,Ww,Ww,Ww,Ww,Ww,Ww,Ww,Ww,Ww,Ww,Ww
Mm,Mm,Mm,Mm,Mm,Mm,Mm,Mm,Mm,Hh,Hh,Ds,Ds,Ww,Ww,Wo,Wo,Wo,Wo,Ww,Ww,Ds,Hh,Hh,Mm,Mm,Mm,Mm,Mm,Mm,Mm,Mm,Mm,Mm,Hh,Hh,Hh,Mm,Mm,Mm,Mm,Hh,Hh,Hh,Hh,Gg,Gg,Gs^Fp,Gs^Fp,Gs^Fp,Gs^Fp,Gs^Fp,Gs^Fp,Ds,Ds,Ww,Ww,Ww,Ww,Ww,Ds,Ds,Chr,Chr,Chr,Ds,Chr,Ds,Ww,Ww
Mm,Mm,Mm,Mm,Mm,Mm,Mm,Mm,Hh,Hh,Hh,Ds,Ww,Ww,Wo,Wo,Wo,Wo,Wo,Ww,Ww,Ds,Ds,Hh,Hh,Hh,Mm,Mm,Mm,Mm,Mm,Mm,Mm,Mm,Mm,Mm,Mm,Mm,Mm,Mm,Mm,Hh,Hh,Gs^Fp,Gs^Fp,Gs^Fp,Gs^Fp,Gs^Fp,Gs^Fp,Gs^Fp,Gs^Fp,Gg^Ve,Ds,Ds,Ww,Ww,Ww,Ww,Ww,Chr,Ds,Ds,Ds,Ds,Ds,Ds,Chr,Ds,Ds,Ww
Mm,Mm,Mm,Mm,Mm,Mm,Mm,Mm,Hh,Hh,Ds,Ds,Ww,Ww,Wo,Wo,Wo,Wo,Wo,Ww,Ww,Ds,Hh,Hh,Mm,Mm,Mm,Mm,Mm,Mm,Mm,Mm,Mm,Mm,Mm,Mm,Mm,Mm,Mm,Hh,Hh,Hh,Gg,Gs^Fp,Gs^Fp,Gs^Fp,Gs^Fp,Gs^Fp,Gs^Fp,Gs^Fp,Gs^Fp,Gs^Fp,Gg,Ds,Ww,Ww,Ww,Ww,Chr,Ds,Ds,Ds,Ds,Chr,Chr,Chr,Ds,Chr,Ww,Ww
Mm,Mm,Mm,Mm,Mm,Mm,Mm,Hh,Hh,Ds,Ds,Ww,Wo,Wo,Wo,Wo,Wo,Wo,Wo,Ww,Ww,Ds,Hh,Hh,Mm,Mm,Mm,Mm,Mm,Mm,Mm,Mm,Mm,Mm,Mm,Mm,Mm,Mm,Hh,Hh,Hh,Gg,Gg,Gg,Gs^Fp,Gs^Fp,Gs^Fp,Ds,Ds,Gs^Fp,Ds,Ds,Ds,Ds,Ww,Ww,Ww,Chr,Chr,Ds,Ds,Ds,Ds,2 Kh,Chr,Ds,Ds,Chr,Ww,Ww
Mm,Mm,Mm,Mm,Mm,Mm,Hh,Hh,Hh,Hh,Ds,Ww,Ww,Wo,Wo,Wo,Wo,Wo,Wo,Ww,Ww,Ds,Ds,Hh,Hh,Mm,Mm,Mm,Mm,Mm,Mm,Mm,Mm,Mm,Mm,Mm,Hh,Hh,Hh,Gg,Gg,Gg,Gg,Gg,Gg,Gg,Gs^Fp,Ds,Ds,Ds,Ds,Ww,Ww,Ww,Ww,Ww,Ww,Ww,Ww,Ds,Ds,Ds,Chr,Chr,Chr,Ds,Ds,Ds,Chr,Ds
Mm,Mm,Mm,Mm,Mm,Hh,Hh,Hh,Ds,Ds,Ds,Ww,Ww,Wo,Wo,Wo,Wo,Wo,Wo,Ww,Ww,Ds,Hh,Hh,Hh,Mm,Mm,Mm,Mm,Mm,Mm,Mm,Mm,Mm,Mm,Hh,Hh,Hh,Gg,Gg,Gg,Gg,Gg,Gg,Gg,Gg,Ds,Ds,Gs^Fp,Ds,Ww,Ww,Ww,Ww,Ww,Ww,Ww,Ww,Chr,Ds,Ds,Ds,Ds,Ds,Chr,Chr,Chr,Chr,Ds,Ww
Mm,Mm,Mm,Mm,Mm,Mm,Hh,Hh,Hh,Ds,Ds,Ww,Ww,Wo,Wo,Wo,Wo,Wo,Wo,Ww,Ww,Ds,Hh,Hh,Hh,Mm,Mm,Mm,Mm,Mm,Mm,Mm,Mm,Mm,Mm,Mm,Hh,Hh,Gg,Gg,Gg,Gg,Gg,Gg,Gg,Gg,Ds,Ds,Ds,Ds,Ww,Ww,Ww,Ww^Vm,Ww,Ww,Ww,Ds,Chr,Ds,Chr,Ds,Ds,Chr,Ww,Ww,Ww,Ww,Ww,Ww
Mm,Mm,Mm,Mm,Mm,Hh,Hh,Hh,Hh,Hh,Ds,Ww,Ww,Wo,Wo,Wo,Wo,Wo,Wo,Ww,Ww,Ds,Ds,Hh,Hh,Hh,Hh,Mm,Mm,Mm,Mm,Mm,Mm,Mm,Hh,Hh,Gs^Fp,Gs^Fp,Gg,Gg,Gg,Gg,Gg,Gg,Gg,Gg,Ds,Ds,Ww,Ww,Ww,Ww,Ww,Ww,Ww,Ww,Ww,Ww,Ww,Ww,Ww,Wwf,Wwf,Wwf,Ww,Ww,Ww^Vm,Ww,Ww,Ww
Mm,Mm,Mm,Mm,Mm,Hh,Hh,Hh,Ds,Ds,Ds,Ww,Ww,Wo,Wo,Wo,Wo,Wo,Wo,Ww,Ww,Ds,Hh,Hh,Mm,Mm,Mm,Mm,Mm,Mm,Mm,Mm,Hh,Hh,Hh,Gs^Fp,Gs^Fp,Gs^Fp,Gg,Gg,Gg,Gg,Gg,Gg,Gg,Gg,Gg,Ds,Ww,Ww,Ww,Ww,Ww,Ww,Ww,Ww,Ww,Ww,Ww,Ww,Wwf,Wwf,Wwf,Wwf,Ww,Ww,Ww,Ww,Ww,Ww
Mm,Mm,Mm,Mm,Mm,Mm,Hh,Hh,Ds,Ww,Ww,Ww,Wo,Wo,Wo,Wo,Wo,Wo,Ww,Ww,Ds,Ds,Hh,Hh,Hh,Mm,Mm,Mm,Mm,Mm,Mm,Hh,Hh,Hh,Gs^Fp,Gs^Fp,Gs^Fp,Gs^Fp,Gs^Fp,Gg,Gg,Gg,Gg,Gg,Gg,Gg,Gg,Ds,Ds,Ww,Ww,Ww,Ww,Ww,Ww,Ww,Ww,Ww,Ww,Ww^Vm,Chr,Chr,Wwf,Chr,Chr,Ww,Ww,Ww,Ww,Ww
Mm,Mm,Mm,Mm,Mm,Hh,Hh,Hh,Ds,Ww,Ww,Wo,Wo,Wo,Wo,Wo,Wo,Ww,Ww,Ds,Ds,Hh,Hh,Hh,Mm,Mm,Mm,Mm,Mm,Mm,Mm,Hh,Gg,Gs^Fp,Gs^Fp,Gs^Fp,Gs^Fp,Gs^Fp,Gs^Fp,Gg,Gg,Gg,Gg,Gg,Gg,Gg,Gg,Gg,Ds,Ww,Ww,Ww,Ww,Ww,Ww,Ww,Ww,Ww,Ww,Ww,Ww,Wwf,Chr,Wwf,Wwf,Ww,Ww,Ww,Ww,Ww
Mm,Mm,Mm,Hh,Hh,Hh,Hh,Ds,Ds,Ww,Ww^Vm,Wo,Wo,Wo,Wo,Wo,Wo,Ww,Ww,Ds,Hh,Hh,Hh,Hh,Mm,Mm,Mm,Mm,Mm,Mm,Mm,Hh,Hh,Hh,Hh,Hh,Gs^Fp,Gs^Fp,Gg,Gg,Gg,Gg,Gg,Gg,Gg,Gg,Gg,Gg,Ds,Ww,Ww,Ww,Ww,Ww,Ww,Ww,Ww,Ww,Ww,Ww,Ww,Wwf,Wwf,Wwf,Ww,Ww,Ww,Ww,Ww,Ww
Mm,Mm,Mm,Mm,Hh,Hh,Ds,Ds,Ww,Ww,Wo,Wo,Wo,Wo,Wo,Wo,Wo,Ww,Ww,Ds,Hh,Hh,Hh,Mm,Mm,Mm,Mm,Mm,Mm,Mm,Mm,Mm,Hh,Hh,Hh,Gs^Fp,Gs^Fp,Gs^Fp,Gs^Fp,Gs^Fp,Gs^Fp,Gg^Ve,Gg,Gg,Gg,Gg,Gg,Gg,Ds,Ww,Ww,Ww^Vm,Ww,Ww,Ww,Ww,Ww,Ww,Ww,Ww,Ww,Wwf,Ds,Ds,Ww,Ww,Ww,Ww,Ww,Ww
Mm,Mm,Mm,Hh,Hh,Hh,Ds,Ds,Ww,Ww,Wo,Wo,Wo,Wo,Wo,Wo,Ww,Ww,Ds,Ds,Hh,Hh,Mm,Mm,Mm,Mm,Mm,Mm,Mm,Mm,Hh,Hh,Hh,Hh,Gs^Fp,Gs^Fp,Gs^Fp,Gs^Fp,Gs^Fp,Gs^Fp,Gs^Fp,Gs^Fp,Gs^Fp,Gg,Gg,Gg,Gg,Gg,Ds,Ww,Ww,Ww,Ww,Ww,Ww,Ww,Ww,Ww,Ww,Ds,Ds,Ds,Gg,Ds,Ds,Ds,Ww,Ww,Ww,Ww
Mm,Mm,Mm,Mm,Hh,Hh,Ds,Ds,Ww,Ww,Wo,Wo,Wo,Wo,Wo,Wo,Ww,Ww,Ds,Gg^Vh,Hh,Hh,Hh,Mm,Mm,Mm,Mm,Mm,Hh,Hh,Hh,Gg,Gg,Gg,Gs^Fp,Gs^Fp,Gg,Gg,Gg,Gs^Fp,Gs^Fp,Gs^Fp,Gs^Fp,Gs^Fp,Gg,Gg,Gg,Ds,Ds,Ww,Ww,Ww,Ww,Ww,Ww,Ww,Ds,Ds,Ds,Ds,Gg,Gg,Gg,Ds,Ww,Ww,Ww,Ww,Ww,Ww
Mm,Mm,Hh,Hh,Hh,Hh,Ds,Ww,Ww,Wo,Wo,Wo,Wo,Wo,Wo,Wo,Ww,Ww,Ds,Ds,Hh,Hh,Hh,Hh,Mm,Mm,Mm,Mm,Hh,Hh,Gg,Gg,Gg,Gg,Gs^Fp,Gg,Gg,Gg,Gg,Gg,Gg,Gs^Fp,Gs^Fp,Gs^Fp,Gg,Ds,Ds,Ds,Ww,Ww,Ww,Ww,Ww,Ww,Ww,Ww,Ww,Ww,Ww,Ds,Ds,Ds,Ds,Ds,Ds,Ww,Ww,Ww,Ww,Ww
Mm,Mm,Mm,Mm,Hh,Hh,Ds,Ds,Ww,Ww,Wo,Wo,Wo,Wo,Wo,Wo,Ww,Ww,Ds,Hh,Hh,Hh,Mm,Mm,Mm,Mm,Mm,Hh,Hh,Gg,Gg,Gg,Gs^Fp,Gs^Fp,Gs^Fp,Gs^Fp,Gg,Gg,Gg,Gg,Gs^Fp,Gs^Fp,Gs^Fp,Gs^Fp,Ds,Ds,Ww,Ww,Ww,Ww,Ww,Ww,Ww,Ww^Vm,Ww,Ww,Ww,Ds,Ds,Ds,Gg,Gg,Ds,Ds,Ww,Ww,Ww,Ww,Ww,Ww
Mm,Mm,Mm,Mm,Hh,Hh,Hh,Ds,Ds,Ww,Ww,Wo,Wo,Wo,Wo,Wo,Ww,Ww,Ds,Ds,Hh,Hh,Hh,Mm,Mm,Hh,Hh,Hh,Gg,Gg,Gs^Fp,Gs^Fp,Gs^Fp,Gs^Fp,Gs^Fp,Gs^Fp,Gs^Fp,Gs^Fp,Gg,Gg,Gg,Gs^Fp,Gg,Gg,Ds,Ww,Ww,Ww,Ww,Ww,Ww,Ww,Ww,Ww,Ww,Ww,Ww,Ww,Ds,Ds,Gg,Gg,Gg,Ds,Ds,Ww,Ww,Ww,Ww,Ww
Mm,Mm,Mm,Mm,Mm,Hh,Hh,Hh,Ds,Ww,Ww,Wo,Wo,Wo,Wo,Wo,Wo,Ww,Ww,Ds,Hh,Hh,Hh,Hh,Hh,Hh,Gg,Gg,Gs^Fp,Gs^Fp,Gs^Fp,Gs^Fp,Gs^Fp,Gs^Fp,Gs^Fp,Gs^Fp,Gs^Fp,Gg,Gg,Gg,Gg,Gg,Gg,Gg,Ds,Ds,Ww,Ww,Ww,Ww,Ww,Ww,Ww,Ww,Ww,Ww,Ww,Ww,Ww,Ds,Ds,Ds,Ds,Ww,Ww,Ww,Ww,Ww,Ww,Ww
Mm,Mm,Mm,Mm,Mm,Hh,Hh,Hh,Ds,Ww,Ww,Wo,Wo,Wo,Wo,Wo,Wo,Ww,Ww,Ds,Ds,Hh,Hh,Hh,Hh,Hh,Gg,Gs^Fp,Gs^Fp,Gs^Fp,Gs^Fp,Gs^Fp,Gs^Fp,Gs^Fp,Gs^Fp,Gs^Fp,Gs^Fp,Gs^Fp,Gg,Gg,Gg,Gg,Gg,Gs^Fp,Gs^Fp,Ds,Ww,Ww,Ww,Ww,Ww,Ww,Ww,Ww,Ww,Ww,Ww,Ww^Bw/,Ww^Bw/,Ww,Ww,Ww,Ww,Ww,Ww,Ww,Ww,Ww,Ww,Ww
Mm,Mm,Mm,Hh,Hh,Hh,Hh,Ds,Ds,Ds,Ww,Ww,Ww,Wo,Wo,Wo,Wo,Wo,Ww,Ww,Ds,Ds,Hh,Hh,Hh,Gg,Gg,Gs^Fp,Gs^Fp,Gs^Fp,Gs^Fp,Gs^Fp,Gg^Ve,Gs^Fp,Gs^Fp,Gs^Fp,Gs^Fp,Gs^Fp,Gs^Fp,Gg,Gg,Gs^Fp,Gs^Fp,Gs^Fp,Ds,Ds,Ww^Bw\,Ww^Bw\,Ww,Ww,Ww,Ds,Ds,Ds,Ds,Ds,Ds,Ww,Ww,Ww,Ww,Ww,Ww,Ww,Ww,Ww,Ww,Ww,Ww,Ww
Mm,Mm,Mm,Mm,Mm,Mm,Hh,Hh,Ds,Ds,Ds,Ds,Ww,Ww,Ww,Wo,Wo,Wo,Wo,Ww,Ww,Ds,Ds,Ds,Gs^Fp,Gs^Fp,Gs^Fp,Gs^Fp,Gs^Fp,Gs^Fp,Hh,Hh,Gs^Fp,Gs^Fp,Gs^Fp,Gs^Fp,Gs^Fp,Gs^Fp,Gs^Fp,Gs^Fp,Gs^Fp,Gs^Fp,Gs^Fp,Ds,Ds,Ww,Ww,Ww,Ww^Bw\,Ww^Bw\,Ww,Ds,Gg,Gg,Gg,Gg,Ds,Ww,Ww,Ww,Ww,Ww,Ww,Ds,Ds,Ds,Ds,Ds,Ww,Ww
Mm,Mm,Mm,Mm,Mm,Mm,Mm,Hh,Hh,Hh,Hh,Ds,Ds,Ds,Ww,Ww,Wo,Wo,Wo,Wo,Ww,Ww,Ww,Ds,Ds,Ds,Gs^Fp,Gs^Fp,Gs^Fp,Gs^Fp,Hh,Hh,Hh,Gs^Fp,Gs^Fp,Gs^Fp,Gs^Fp,Gs^Fp,Gs^Fp,Gg,Gs^Fp,Gs^Fp,Ds,Ds,Ww,Ww,Wo,Wo,Ww,Ww,Ds,Ds,Gg,Gg,Ds,Ds,Ww,Ww,Ww,Ww,Ww,Ww,Ds,Ds,Gg,Gg,Chr,Ds,Ww,Ww
Mm,Mm,Mm,Mm,Mm,Mm,Mm,Mm,Mm,Mm,Hh,Hh,Hh,Ds,Ww,Ww^Vm,Wo,Wo,Wo,Wo,Wo,Wo,Ww,Ds,Ds,Gs^Fp,Gs^Fp,Gs^Fp,Gs^Fp,Gs^Fp,Hh,Hh,Hh,Gs^Fp,Gs^Fp,Gs^Fp,Gs^Fp,Gs^Fp,Gg,Gg,Gg,Ds,Ds,Ww,Ww,Wo,Wo,Wo,Wo,Ww,Ww,Ds,Ds,Ds,Ds,Ds,Ds,Ww,Ww,Ds,Ds,Ds,Ds,Ds,Ds,Ds,Ww^Bw|,Ww,Ww,Ww
Mm,Mm,Mm,Mm,Mm,Mm,Mm,Mm,Mm,Mm,Hh,Ds,Ds,Ds,Ds,Ww,Ww,Wo,Wo,Wo,Wo,Wo,Ww,Ww,Ds,Ds,Ds,Gs^Fp,Gs^Fp,Gs^Fp,Gs^Fp,Gs^Fp,Gs^Fp,Gs^Fp,Gs^Fp,Gg,Gg,Gg,Gg,Gg,Ds,Ds,Ww,Ww,Wo,Wo,Wo,Wo,Wo,Wo,Ww,Ww,Ww,Ds,Gg,Gg^Vh,Ds,Ds,Ds,Ds,Ds,Ww,Ww,Ww,Ww,Ww,Ww^Bw|,Ww,Ww,Ww
Mm,Mm,Mm,Mm,Mm,Mm,Mm,Mm,Mm,Mm,Hh,Hh,Hh,Ds,Ds,Ds,Ww,Ww,Wo,Wo,Wo,Wo,Wo,Ww,Ww,Ww,Ds,Ds,Gs^Fp,Gs^Fp,Gs^Fp,Gs^Fp,Gs^Fp,Gs^Fp,Gs^Fp,Gg,Gg,Gg,Gs^Fp,Ds,Ds,Ww,Ww,Wo,Wo,Wo,Wo,Wo,Wo,Wo,Ww,Ww,Ds,Ds,Gg,Gg,Gg,Gg,Ds,Ww,Ww,Ww,Wo,Wo,Ww,Ww,Ww^Bw|,Ww,Ww,Ww
Mm,Mm,Mm,Mm,Mm,Mm,Mm,Mm,Mm,Mm,Mm,Mm,Mm,Hh,Hh,Ds,Ds,Ww,Ww,Wo,Wo,Wo,Wo,Wo,Wo,Ww,Ww,Ds,Ds,Gs^Fp,Gs^Fp,Gs^Fp,Gs^Fp,Gs^Fp,Gs^Fp,Gg,Ds,Ds,Ds,Ds,Ww,Ww^Vm,Wo,Wo,Wo,Wo,Wo,Wo,Wo,Wo,Ww,Ds,Ds,Gg,Gg,Gg,Ds,Ds,Ww,Ww,Wo,Wo,Wo,Wo,Ww,Ww,Ww^Bw|,Ww,Ww,Ww
Mm,Mm,Mm,Mm,Mm,Mm,Mm,Mm,Mm,Mm,Mm,Mm,Mm,Mm,Hh,Hh,Ds,Ds,Ww,Ww,Wo,Wo,Wo,Wo,Wo,Wo,Ww,Wwf,Ds,Ds,Ds,Gs^Fp,Gs^Fp,Gs^Fp,Gg,Ds,Ds,Ww,Ww,Ww,Ww,Wo,Wo,Wo,Wo,Wo,Wo,Wo,Wo,Ww,Ww,Ww,Ds,Gg,Ds,Ds,Ww,Ww,Ww,Wo,Wo,Wo,Wo,Wo,Ww,Ww,Ww^Bw|,Ww,Ww,Ww
Mm,Mm,Mm,Mm,Mm,Mm,Mm,Mm,Mm,Mm,Mm,Mm,Mm,Mm,Mm,Hh,Hh,Ds,Ds,Ww,Ww,Wo,Wo,Wo,Wo,Ww,Ww,Wwf,Wwf,Wwf,Ds,Ds,Ds,Gs^Fp,Gs^Fp,Ds,Ww,Ww,Wo,Wo,Wo,Wo,Wo,Wo,Wo,Wo,Wo,Wo,Ww,Ww,Ds,Ds,Ds,Ds,Ww,Ww,Ww,Wo,Wo,Wo,Wo,Wo,Wo,Ww,Ww,Ww,Chr,Ds,Ds,Ds
Mm,Mm,Mm,Mm,Mm,Mm,Mm,Mm,Mm,Mm,Mm,Mm,Mm,Mm,Hh,Hh,Hh,Hh,Ds,Ds,Ww,Ww,Wo,Ww,Ww,Ww,Ds,Ds,Wwf,Wwf,Wwf,Wwf,Ds,Ds,Gs^Fp,Ds,Ww,Ww,Wo,Wo,Wo,Wo,Wo,Wo,Wo,Wo,Ww,Ww,Ww,Chr,Ds,Ds,Ds,Ww,Ww,Wo,Wo,Wo,Wo,Wo,Wo,Wo,Ww,Ww,Ds,Ds,Ds,Gg,Gg,Gg
Mm,Mm,Mm,Mm,Mm,Mm,Mm,Mm,Mm,Mm,Mm,Mm,Mm,Mm,Mm,Hh,Hh,Hh,Gg^Ve,Ds,Ww,Ww,Ww,Wwf,Wwf,Ds,Gg,Ds,Ww,Ww,Ww,Ww,Ww,Ds,Ds,Ds,Ww,Ww,Wo,Wo,Wo,Wo,Wo,Wo,Ww,Ww,Ww,Ww^Bw/,Ww^Bw/,Ww,Ww,Ww,Ww,Ww,Wo,Wo,Wo,Wo,Wo,Wo,Wo,Ww,Ww,Ds,Ds,Gg,Gg,Gg,Gg,Gg
Mm,Mm,Mm,Mm,Mm,Mm,Mm,Mm,Mm,Mm,Mm,Mm,Mm,Hh,Hh,Hh,Gg,Hh,Gs^Fp,Ds,Ds,Ww,Wwf,Wwf,Wwf,Ds,Ds,Ww,Ww,Wo,Wo,Wo,Ww,Ww,Ww,Ww,Ww,Wo,Wo,Wo,Wo,Wo,Wo,Wo,Ww,Ww^Bw/,Ww^Bw/,Ww,Ww,Ww,Wo,Wo,Wo,Wo,Wo,Wo,Wo,Wo,Wo,Wo,Ww,Ww,Ww,Ds,Gg,Gg,Gg,Gg,Gg,Gg
Mm,Mm,Mm,Mm,Mm,Mm,Mm,Mm,Mm,Hh,Hh,Hh,Hh,Gg,Hh,Gg,Gg,Gs^Fp,Gs^Fp,Gs^Fp,Ds,Ds,Wwf,Wwf,Wwf,Wwf,Ww,Wo,Ww,Ww,Ww,Ww,Wo,Wo,Wo,Wo,Wo,Wo,Wo,Wo,Wo,Ww,Ww,Ww,Chr,Ww,Ds,Ww,Ww,Wo,Wo,Wo,Wo,Wo,Wo,Wo,Wo,Wo,Wo,Ww,Ww,Ds,Ds,Ds,Gg,Gg,Gg,Gg,Gg,Gg
Mm,Mm,Mm,Mm,Mm,Mm,Mm,Hh,Hh,Hh,Hh,Hh,Hh,Gg,Gg,Gg,Gs^Fp,Gs^Fp,Gs^Fp,Gs^Fp,Gs^Fp,Ds,Wwf,Wwf,Wwf,Ww,Wo,Wo,Ww,Ds,Ds,Ww,Wo,Wo,Wo,Wo,Wo,Wo,Wo,Wo,Wo,Ww^Vm,Ww,Ds,Ww^Bw|,Ds,Ds,Ww,Ww,Wo,Wo,Wo,Wo,Wo,Wo,Wo,Wo,Wo,Ww,Ww,Ds,Ds,Gg,Gg,Gg^Vh,Gg,Gg,Gg,Gg,Gg
Hh,Hh,Hh,Hh,Hh,Hh,Hh,Hh,Gs^Fp,Gs^Fp,Gs^Fp,Gs^Fp,Gg,Gg,Gg,Gs^Fp,Gs^Fp,Gs^Fp,Gs^Fp,Gs^Fp,Gs^Fp,Ds,Ds,Wwf,Ww,Ww,Wo,Wo,Ww,Ww,Ww,Ww,Wo,Wo,Wo,Wo,Wo,Wo,Wo,Wo,Ww,Ww,Ww,Ww^Bw/,Chr,Ds,Ds,Ww,Ww,Wo,Wo,Wo,Wo,Wo,Wo,Wo,Wo,Ww,Ww,Ds,Ds,Gg,Gg,Gg,Gg,Gg,Gg,Gg,Gg,Gg
Hh,Hh,Hh,Hh,Hh,Gs^Fp,Gs^Fp,Gs^Fp,Gs^Fp,Gs^Fp,Gs^Fp,Gs^Fp,Gs^Fp,Gg,Gs^Fp,Gs^Fp,Gs^Fp,Gs^Fp,Gs^Fp,Gs^Fp,Gg,Gg,Ds,Ww,Ww,Wo,Wo,Wo,Wo,Wo,Wo,Wo,Wo,Wo,Wo,Wo,Wo,Wo,Ww,Ww,Ww,Ww^Bw/,Ww^Bw/,Ww,Ww,Ww,Ww,Ww,Wo,Wo,Wo,Wo,Wo,Wo,Wo,Wo,Ww,Ww,Ds,Ds,Gg,Gg,Gg,Gg,Gg,Gg,Gg,Gg,Gg,Gg
Gg,Gg,Gg,Gg,Gs^Fp,Gs^Fp,Gs^Fp,Gg^Ve,Gs^Fp,Gs^Fp,Gs^Fp,Gs^Fp,Gs^Fp,Gs^Fp,Gs^Fp,Gs^Fp,Gs^Fp,Gs^Fp,Gs^Fp,Gs^Fp,Gg,Gg,Ds,Ds,Ww,Ww,Wo,Wo,Wo,Wo,Wo,Wo,Wo,Wo,Wo,Wo,Ww,Ww,Ww,Chr,Ww^Bw/,Ww,Ww,Wo,Wo,Wo,Wo,Wo,Wo,Wo,Wo,Wo,Wo,Wo,Ww,Ww,Ww,Ds,Ds,Gg,Gg,Gg,Gg,Gg,Gg,Gg,Gg,Gg,Gg,Gg
Gg,Gg,Gg,Gg,Gg,Gs^Fp,Gs^Fp,Gs^Fp,Gs^Fp,Gs^Fp,Gs^Fp,Gs^Fp,Gs^Fp,Gs^Fp,Gg^Ve,Gs^Fp,Gs^Fp,Gg^Ve,Gs^Fp,Gg,Gg,Gg,Gg,Ds,Ww,Ww,Wo,Wo,Wo,Wo,Wo,Wo,Wo,Wo,Ww,Ww,Ww,Ww,Ww,3 Kh,Chr,Chr,Ww,Ww,Wo,Wo,Wo,Wo,Wo,Wo,Wo,Wo,Wo,Ww,Ww,Ds,Ds,Ds,Gg,Gg,Gg,Gg,Gg,Gg,Gg,Gg,Gg,Hh,Hh,Hh
Gg,Gg,Gg,Gg,Gg,Gg,Gs^Fp,Gs^Fp,Gs^Fp,Gs^Fp,Gs^Fp,Gg,Gg,Gs^Fp,Gs^Fp,Gs^Fp,Gs^Fp,Gs^Fp,Gs^Fp,Gg,Gg,Ds,Ds,Ds,Ww,Ww,Wo,Wo,Wo,Wo,Wo,Ww,Ww,Ww,Ww,Ww,Ww,Ww^Bw/,Ww^Bw/,Chr,Ww,Ww,Ww,Wo,Wo,Wo,Wo,Wo,Wo,Wo,Wo,Wo,Wo,Ww,Ww,Ds,Gg,Gg,Gg,Gg,Gg,Gg,Gg,Gg,Hh,Hh,Hh,Hh,Hh,Hh
Gg,Gg,Gg,Gg,Gg,Gg,Gg,Gs^Fp,Gs^Fp,Gs^Fp,Gg,Gg,Gg,Gg,Gs^Fp,Gs^Fp,Gs^Fp,Gs^Fp,Gs^Fp,Gs^Fp,Ds,Ds,Ds,Ww,Ww,Wo,Wo,Wo,Wo,Ww,Ww,Ww,Ds,Ww,Ww,Ww^Bw/,Ww^Bw/,Ww,Ww,Ww,Ww,Wo,Wo,Wo,Wo,Ww,Ww,Wo,Wo,Wo,Wo,Wo,Wo,Ww,Ww,Ds,Gg,Gg,Gg,Gg,Gg,Hh,Hh,Hh,Hh,Hh,Mm,Mm,Mm,Mm
Gs^Fp,Gg^Ve,Gg,Gg,Gg,Gg,Gg,Gg,Gs^Fp,Gg,Gg,Gg,Gg,Gg,Gs^Fp,Gs^Fp,Gs^Fp,Gs^Fp,Gs^Fp,Ds,Ds,Ww,Ww,Ww,Wo,Wo,Wo,Ww,Ww,Ww,Ds,Ds,Ds,Chr,Ww^Bw/,Ww,Wo,Wo,Wo,Wo,Wo,Wo,Wo,Wo,Wo,Wo,Wo,Wo,Wo,Wo,Wo,Wo,Ww,Ww,Ww,Ds,Gg,Gg,Gg^Vh,Gg,Hh,Hh,Mm,Mm,Mm,Mm,Mm,Mm,Mm,Mm
Gs^Fp,Gs^Fp,Gg,Gg,Gg,Gg,Gg,Ds,Gg,Gg,Gg,Gg,Gg,Gg,Gg,Gg,Ds,Ds,Ds,Ds,Ww,Ww,Ww,Wo,Wo,Wo,Ww,Ww,Ww,Ww,Ww,Gg,Gg,Ds,Ds,Ww,Ww,Wo,Wo,Wo,Wo,Wo,Wo,Wo,Wo,Wo,Wo,Wo,Wo,Wo,Ww,Ww,Ww,Ds,Ds,Ds,Gg,Hh,Hh,Hh,Hh,Mm,Mm,Mm,Mm,Mm,Mm,Mm,Mm,Mm
Gs^Fp,Gs^Fp,Gs^Fp,Gg,Gg,Ds,Ds,Ds,Ds,Ds,Ds,Ds,Gg,Gg,Gg,Ds,Ww,Ww,Ww,Ww,Ww^Bw\,Ww^Bw\,Ww,Ww,Ww,Ww,Ww,Ww,Ww,Chr,Ww^Bw/,Ww,Ww,Ds,Ww,Ww,Wo,Wo,Wo,Wo,Wo,Wo,Wo,Wo,Wo,Wo,Wo,Wo,Ww,Ww,Ww,Ds,Ds,Ds,Gg,Hh,Hh,Mm,Mm,Mm,Mm,Mm,Mm,Mm,Mm,Mm,Mm,Mm,Mm,Mm
Gs^Fp,Gs^Fp,Gs^Fp,Ds,Ds,Ds,Chw,Chr,Chw,Chw,Chw,Ds,Ds,Ds,Ds,Ds,Ww,Ww,Wo,Ww,Ww,Ww,Ww^Bw\,Ww^Bw\,Ww,Ds,Ds,Ds,Ww^Bw/,Ww,Ww,Ww,Ww,Ww,Ww^Vm,Wo,Wo,Wo,Wo,Wo,Wo,Wo,Wo,Wo,Wo,Wo,Ww,Ww,Ww,Ds,Ds,Ds,Hh,Hh,Hh,Hh,Hh,Mm,Mm,Mm,Mm,Mm,Mm,Mm,Mm,Mm,Mm,Mm,Mm,Mm
Gs^Fp,Gs^Fp,Gs^Fp,Ds,Chw,Chr,Chr,Ww,Ww,Ww,Chw,Ds,Ds,Ds,Ww,Ww,Ww,Wo,Wo,Wo,Wo,Ww,Ww,Ww,Ds,Ds,Gg,Gg,Gg,Ds,Ds,Ww,Ww,Wo,Wo,Wo,Wo,Wo,Wo,Wo,Wo,Wo,Wo,Wo,Wo,Ww,Ww,Ds,Ds,Ds,Hh,Hh,Hh,Mm,Mm,Mm,Mm,Mm,Mm,Mm,Mm,Mm,Mm,Mm,Mm,Mm,Mm,Mm,Mm,Mm
Gs^Fp,Gg,Gg,Ds,Chw,Ww,1 Kh,Ww,Ww,Chw,Chw,Ds,Ds,Ww,Ww,Wo,Wo,Wo,Wo,Wo,Wo,Wo,Wo,Ww,Ww,Ds,Ds,Ds,Ds,Chr,Ww,Ww,Wo,Wo,Wo,Wo,Wo,Wo,Wo,Wo,Wo,Ww,Ww,Ww,Ww,Ww,Ds,Ds,Gg,Gg,Hh,Hh,Mm,Mm,Mm,Mm,Mm,Mm,Mm,Mm,Mm,Mm,Mm,Mm,Mm,Mm,Mm,Mm,Mm,Mm
Gg,Gs^Fp,Ds,Ds,Chr,Ww,Ww,Ww,Ww,Ww,Ww,Ds,Ds,Ww,Wo,Wo,Wo,Wo,Wo,Wo,Wo,Wo,Wo,Wo,Ww,Ww,Ds,Ww,Ww,Ww,Ww^Bw\,Ww^Bw\,Ww,Ww,Wo,Wo,Ww,Ww,Ww,Ww,Ww,Ww,Ds,Ds,Ds,Ds,Gg,Gg,Gg,Hh,Hh,Mm,Mm,Mm,Mm,Mm,Mm,Mm,Mm,Mm,Mm,Mm,Mm,Mm,Mm,Mm,Mm,Mm,Mm,Mm
Gg,Gs^Fp,Ds,Ww,Chw,Chw,Chw,Chw,Chw,Ww,Ww,Ww,Ww,Ww,Wo,Wo,Wo,Wo,Wo,Wo,Wo,Wo,Wo,Wo,Wo,Ww,Ww,Ww,Wo,Ww,Ww,Ww,Ww^Bw\,Ww^Bw\,Ww,Ww,Ww,Ds,Ds,Ds,Ds,Ds,Ds,Gg,Gg,Gg,Gg,Gg,Hh,Hh,Mm,Mm,Mm,Mm,Mm,Mm,Mm,Mm,Mm,Mm,Mm,Mm,Mm,Mm,Mm,Mm,Mm,Mm,Mm,Mm
Ds,Ds,Ds,Ww,Ww,Ww,Ww,Ww,Ww,Ww,Ww,Ww,Ww,Ww,Wo,Wo,Wo,Wo,Wo,Wo,Wo,Wo,Wo,Wo,Wo,Wo,Wo,Wo,Wo,Ww,Ww,Ww,Ww,Ww,Ds,Ds,Ds,Ds,Gg,Gg,Gg,Gg,Gg,Gg,Hh,Hh,Hh,Hh,Hh,Hh,Mm,Mm,Mm,Mm,Mm,Mm,Mm,Mm,Mm,Mm,Mm,Mm,Mm,Mm,Mm,Mm,Mm,Mm,Mm,Mm
Ds,Ww,Ww,Ww,Ww,Ww,Ww,Ww,Ww,Ww,Wo,Ww^Vm,Wo,Wo,Wo,Wo,Wo,Wo,Wo,Wo,Wo,Wo,Wo,Wo,Ww,Ww,Ww,Ww,Ww,Ww,Ds,Ds,Ds,Ds,Ds,Gg,Gg,Gg,Gg,Hh,Hh,Hh,Hh,Hh,Hh,Hh,Hh,Hh,Hh,Mm,Mm,Mm,Mm,Mm,Mm,Mm,Mm,Mm,Mm,Mm,Mm,Mm,Mm,Mm,Mm,Mm,Mm,Mm,Mm,Mm
Ww,Ww,Ww,Ww,Ww,Wo,Wo,Wo,Wo,Wo,Wo,Wo,Wo,Wo,Wo,Wo,Wo,Wo,Wo,Wo,Wo,Ww,Ww,Ww,Ww,Ds,Ds,Ds,Ds,Ds,Ds,Gg,Gg,Gg,Gg,Gg,Gg,Gg,Gg,Gg,Gg,Gg,Hh,Hh,Hh,Hh,Hh,Mm,Mm,Mm,Mm,Mm,Mm,Mm,Mm,Mm,Mm,Mm,Mm,Mm,Mm,Mm,Mm,Mm,Mm,Mm,Mm,Mm,Mm,Mm
Ww,Wo,Wo,Wo,Wo,Wo,Wo,Wo,Wo,Wo,Wo,Wo,Wo,Wo,Wo,Wo,Wo,Wo,Wo,Wo,Ww,Ww,Ds,Ds,Ds,Ds,Gg,Gg,Gg,Gg,Gg,Gg,Gg,Gg,Gg,Gg^Vh,Gg,Gg,Gg,Gg,Gg,Gg,Gg,Hh,Hh,Hh,Mm,Mm,Mm,Mm,Mm,Mm,Mm,Mm,Mm,Mm,Mm,Mm,Mm,Mm,Mm,Mm,Mm,Mm,Mm,Mm,Mm,Mm,Mm,Mm
Wo,Wo,Wo,Wo,Wo,Wo,Wo,Wo,Wo,Wo,Wo,Wo,Wo,Wo,Wo,Wo,Wo,Wo,Wo,Wo,Ww,Ww,Ds,Gg,Gg,Gg,Gg,Gg,Gg,Gg,Gg,Gg,Gg,Gg,Gg,Gg,Gg,Gg,Hh,Hh,Hh,Hh,Hh,Hh,Hh,Hh,Mm,Mm,Mm,Mm,Mm,Mm,Mm,Mm,Mm,Mm,Mm,Mm,Mm,Mm,Mm,Mm,Mm,Mm,Mm,Mm,Mm,Mm,Mm,Mm