border_size=1
usage=map

       Re,       Re,       Rr,    Gs^Fp,       Rr,    Gs^Fp,    Gs^Fp,    Gs^Fp,    Gs^Fp,    Gs^Fp,    Gs^Fp,    Gs^Fp,    Gs^Fp,    Gs^Fp,    Gs^Fp,    Gs^Fp,    Gs^Fp,    Gs^Fp,    Gs^Fp,       Ww,       Gg,       Gg,       Gg,    Gs^Fp,    Gs^Fp,    Gs^Fp,    Gs^Fp,    Gs^Fp,    Gs^Fp,    Gs^Fp,       Hh,       Mm,       Mm,       Hh,       Mm,       Hh,       Mm,    Gs^Fp,    Gs^Fp,    Gs^Fp,    Gs^Fp,    Gs^Fp
       Re,       Re,       Rr,    Gs^Fp,       Rr,    Gs^Fp,    Gs^Fp,    Gs^Fp,    Gs^Fp,    Gs^Fp,    Gs^Fp,    Gs^Fp,    Gs^Fp,    Gs^Fp,    Gs^Fp,    Gs^Fp,    Gs^Fp,    Gs^Fp,    Gs^Fp,       Ww,       Gg,       Gg,       Gg,    Gs^Fp,    Gs^Fp,    Gs^Fp,    Gs^Fp,    Gs^Fp,    Gs^Fp,    Gs^Fp,       Hh,       Mm,       Mm,       Hh,       Mm,       Hh,       Mm,    Gs^Fp,    Gs^Fp,    Gs^Fp,    Gs^Fp,    Gs^Fp
    Gs^Fp,    Gs^Fp,    Gs^Fp,       Rr,    Gs^Fp,       Rr,    Gs^Fp,    Gs^Fp,    Gs^Fp,    Gs^Fp,    Gs^Fp,    Gs^Fp,    Gs^Fp,    Gs^Fp,    Gs^Fp,    Gs^Fp,    Gg^Vh,    Gs^Fp,       Ww,       Ww,    Gs^Fp,       Gg,    Gs^Fp,    Gs^Fp,    Gs^Fp,    Gs^Fp,       Mm,       Mm,       Hh,    Gs^Fp,    Gs^Fp,       Mm,       Hh,      Qxu,      Qxu,       Mm,       Mm,       Mm,       Hh,    Gs^Fp,    Gs^Fp,    Gs^Fp
    Gs^Fp,    Gs^Fp,    Gs^Fp,    Gs^Fp,    Gs^Fp,       Rr,       Rr,    Gs^Fp,       Ce,       Ce,       Gg,    Gg^Vh,       Gg,    Gs^Fp,    Gs^Fp,    Gs^Fp,    Gs^Fp,       Wo,       Ww,    Gs^Fp,    Gs^Fp,    Gs^Fp,       Mm,    Gs^Fp,       Mm,       Hh,       Mm,       Mm,       Mm,       Mm,       Mm,    Gs^Fp,       Mm,       Mm,    Gs^Fp,       Mm,      Qxu,       Mm,       Hh,    Gs^Fp,    Gs^Fp,    Gs^Fp
       Gg,       Gg,    Gs^Fp,    Gs^Fp,    Gs^Fp,    Gs^Fp,       Ce,     1 Ke,       Rr,       Gg,    Gg^Vh,       Gg,       Gg,       Gg,    Gs^Fp,    Gs^Fp,    Gs^Fp,       Wo,       Ww,    Gs^Fp,    Gs^Fp,    Gs^Fp,    Gs^Fp,       Mm,       Mm,       Mm,    Gs^Fp,      Qxu,       Mm,       Mm,       Mm,       Hh,      Qxu,       Mm,       Mm,       Mm,      Qxu,       Mm,       Hh,    Gs^Fp,    Gs^Fp,    Gs^Fp
       Gg,       Gg,    Gs^Fp,    Gs^Fp,    Gs^Fp,       Ce,    Gg^Vh,       Gg,       Gg,       Rr,       Rr,       Gg,    Gs^Fp,    Gg^Vh,       Ce,    Gs^Fp,    Gs^Fp,       Ww,    Gs^Fp,    Gs^Fp,    Gs^Fp,    Gs^Fp,    Gs^Fp,       Hh,       Mm,      Qxu,       Mm,       Mm,      Qxu,      Qxu,      Qxu,      Qxu,    Gs^Fp,      Qxu,      Qxu,       Mm,       Mm,       Hh,    Gs^Fp,    Gs^Fp,    Gs^Fp,    Gs^Fp
       Gg,       Gg,    Gs^Fp,    Gs^Fp,    Gs^Fp,    Gs^Fp,       Gg,       Gg,       Gg,       Gg,    Gs^Fp,       Rr,     2 Ke,       Ce,    Gs^Fp,    Gs^Fp,       Ww,       Ww,    Gg^Vh,       Gg,       Gg,    Gs^Fp,    Gs^Fp,    Gs^Fp,       Hh,       Mm,       Hh,      Qxu,    Gs^Fp,       Gg,       Ch,       Gg,       Ch,    Gs^Fp,       Mm,       Mm,      Qxu,       Mm,       Hh,    Gs^Fp,    Gs^Fp,    Gs^Fp
    Gs^Fp,    Gs^Fp,    Gs^Fp,    Gs^Fp,    Gs^Fp,    Gs^Fp,    Gg^Vh,    Gs^Fp,       Gg,    Gs^Fp,       Ce,       Ce,       Rr,       Rr,   Ww^Bw\,       Ww,       Ww,    Gs^Fp,    Gs^Fp,       Gg,       Gg,    Gs^Fp,    Gs^Fp,    Gs^Fp,    Gs^Fp,       Mm,       Mm,      Qxu,       Gg,    Gs^Fp,       Ch,     3 Kh,       Ch,       Gg,      Qxu,       Mm,    Gs^Fp,       Mm,       Hh,    Gs^Fp,    Gs^Fp,    Gs^Fp
    Gs^Fp,    Gs^Fp,    Gs^Fp,    Gs^Fp,    Gs^Fp,    Gs^Fp,    Gs^Fp,    Gg^Vh,    Gs^Fp,    Gs^Fp,       Ww,       Ww,   Ww^Bw|,       Ww,    Gs^Fp,       Re,       Re,       Ww,       Ww,    Gs^Fp,    Gs^Fp,    Gs^Fp,    Gs^Fp,    Gs^Fp,       Mm,       Mm,       Mm,      Qxu,      Qxu,    Gs^Fp,       Gg,       Gg,       Gg,    Gs^Fp,      Qxu,       Mm,       Hh,       Hh,    Gs^Fp,    Gs^Fp,    Gs^Fp,    Gs^Fp
    Gs^Fp,    Gs^Fp,    Gs^Fp,    Gs^Fp,    Gs^Fp,    Gs^Fp,       Ww,    Gs^Fp,       Ww,       Ww,    Gs^Fp,       Ww,       Re,    Gs^Fp,    Gs^Fp,       Gg,    Gg^Vh,       Re,       Re,       Ww,       Ww,    Gs^Fp,    Gs^Fp,    Gs^Fp,    Gs^Fp,       Hh,       Hh,       Mm,       Mm,      Qxu,      Qxu,       Gg,       Gg,      Qxu,       Mm,       Mm,    Gs^Fp,       Mm,    Gs^Fp,    Gs^Fp,       Re,       Re
    Gs^Fp,    Gs^Fp,    Gs^Fp,    Gs^Fp,       Ww,       Ww,    Gs^Fp,       Ww,    Gs^Fp,    Gs^Fp,       Re,       Re,       Gg,       Gg,       Gg,       Gg,    Gs^Fp,    Gs^Fp,       Re,    Gs^Fp,    Gs^Fp,       Ww,    Gs^Fp,    Gs^Fp,    Gs^Fp,    Gs^Fp,    Gs^Fp,       Mm,       Mm,       Mm,       Hh,    Gs^Fp,    Gs^Fp,       Mm,    Gs^Fp,       Mm,       Mm,    Gs^Fp,       Re,    Gs^Fp,       Re,       Re
    Gs^Fp,    Gs^Fp,       Ww,       Ww,    Gs^Fp,    Gs^Fp,    Gs^Fp,    Gs^Fp,       Re,    Gs^Fp,    Gs^Fp,    Gs^Fp,    Gs^Fp,    Gs^Fp,       Hh,    Gs^Fp,    Gs^Fp,       Re,    Gs^Fp,    Gs^Fp,    Gs^Fp,       Ww,       Ww,    Gs^Fp,    Gs^Fp,    Gs^Fp,    Gs^Fp,    Gs^Fp,    Gs^Fp,       Mm,       Mm,    Gs^Fp,       Re,    Gs^Fp,       Mm,       Mm,       Re,       Re,    Gs^Fp,       Re,    Gs^Fp,    Gs^Fp
       Ww,       Ww,       Ww,    Gs^Fp,    Gs^Fp,    Gg^Vh,    Gs^Fp,    Gs^Fp,       Re,    Gs^Fp,    Gs^Fp,    Gs^Fp,    Gs^Fp,    Gg^Vh,       Hh,       Hh,       Hh,       Re,       Hh,       Hh,       Hh,    Gs^Fp,    Gs^Fp,       Ww,    Gs^Fp,    Gs^Fp,    Gs^Fp,    Gs^Fp,    Gs^Fp,    Gs^Fp,    Gs^Fp,    Gs^Fp,    Gs^Fp,       Re,       Re,       Re,       Hh,       Hh,    Gs^Fp,    Gs^Fp,    Gs^Fp,    Gs^Fp
    Gs^Fp,    Gs^Fp,    Gs^Fp,    Gs^Fp,    Gs^Fp,    Gs^Fp,    Gs^Fp,    Gs^Fp,       Re,    Gs^Fp,    Gs^Fp,    Gs^Fp,    Gs^Fp,    Gs^Fp,    Gs^Fp,       Hh,       Hh,       Re,       Re,       Hh,    Gs^Fp,    Gs^Fp,       Ww,       Ww,    Gs^Fp,    Gs^Fp,       Re,    Gs^Fp,    Gs^Fp,    Gs^Fp,    Gs^Fp,    Gs^Fp,       Re,       Re,    Gs^Fp,       Hh,    Gs^Fp,    Gs^Fp,    Gs^Fp,    Gs^Fp,    Gs^Fp,    Gs^Fp
    Gs^Fp,    Gs^Fp,       Re,    Gs^Fp,    Gs^Fp,    Gs^Fp,    Gs^Fp,    Gs^Fp,       Re,       Re,       Re,    Gs^Fp,    Gs^Fp,    Gs^Fp,    Gs^Fp,    Gs^Fp,    Gs^Fp,       Hh,       Re,    Gs^Fp,    Gs^Fp,    Gs^Fp,    Gs^Fp,       Ss,       Re,       Re,    Gs^Fp,       Re,    Gs^Fp,       Re,    Gs^Fp,       Re,    Gs^Fp,    Gs^Fp,    Gs^Fp,    Gs^Fp,    Gs^Fp,    Gs^Fp,    Gs^Fp,    Gs^Fp,    Gs^Fp,    Gs^Fp
       Re,       Re,    Gs^Fp,       Re,       Re,    Gs^Fp,       Re,    Gs^Fp,    Gs^Fp,    Gs^Fp,    Gs^Fp,       Re,       Re,    Gs^Fp,    Gs^Fp,    Gs^Fp,    Gs^Fp,    Gs^Fp,       Re,    Gs^Fp,    Gs^Fp,    Gs^Fp,       Re,   Ww^Bw/,       Ss,    Gs^Fp,       Hh,    Gs^Fp,    Gs^Fp,       Re,       Re,    Gs^Fp,    Gs^Fp,    Gs^Fp,    Gs^Fp,    Gs^Fp,       Gg,       Gg,       Gg,    Gg^Vh,    Gs^Fp,    Gs^Fp
    Gs^Fp,    Gs^Fp,    Gg^Vh,    Gs^Fp,    Gs^Fp,       Re,    Gs^Fp,    Gs^Fp,    Gs^Fp,    Gs^Fp,    Gs^Fp,    Gs^Fp,       Re,    Gs^Fp,    Gs^Fp,    Gs^Fp,    Gs^Fp,    Gs^Fp,    Gs^Fp,       Re,       Re,       Re,    Gs^Fp,       Ss,       Ss,       Hh,       Hh,    Gs^Fp,    Gg^Vh,    Gs^Fp,    Gs^Fp,       Re,       Re,    Gs^Fp,    Gs^Fp,    Gs^Fp,       Gg,       Gg,       Gg,       Gg,    Gs^Fp,    Gs^Fp
    Gs^Fp,    Gs^Fp,    Gs^Fp,    Gs^Fp,    Gs^Fp,    Gs^Fp,       Re,       Re,       Re,    Gs^Fp,    Gs^Fp,       Re,    Gs^Fp,    Gs^Fp,    Gs^Fp,    Gs^Fp,    Gs^Fp,    Gs^Fp,    Gs^Fp,    Gs^Fp,    Gs^Fp,       Re,    Gs^Fp,    Gs^Fp,    Gs^Fp,       Ww,    Gs^Fp,       Gg,    Gs^Fp,    Gs^Fp,       Re,       Re,       Gg,    Gs^Fp,       Re,    Gs^Fp,       Gg,       Gg,    Gs^Fp,    Gs^Fp,    Gs^Fp,    Gs^Fp
    Gs^Fp,    Gs^Fp,       Re,       Re,    Gs^Fp,       Re,    Gs^Fp,    Gs^Fp,    Gs^Fp,       Re,       Re,       Re,    Gs^Fp,    Gs^Fp,    Gs^Fp,    Gs^Fp,    Gs^Fp,    Gs^Fp,    Gs^Fp,       Hh,       Hh,    Gs^Fp,       Hh,       Hh,    Gs^Fp,       Ww,    Gs^Fp,    Gs^Fp,    Gs^Fp,    Gs^Fp,       Re,       Gg,       Gg,    Gs^Fp,    Gs^Fp,       Re,       Re,    Gs^Fp,    Gs^Fp,    Gs^Fp,       Re,       Re
    Gs^Fp,    Gs^Fp,       Re,    Gs^Fp,    Gs^Fp,       Re,       Re,    Gs^Fp,       Gg,    Gs^Fp,    Gs^Fp,       Re,       Re,    Gs^Fp,    Gs^Fp,    Gs^Fp,       Re,    Gs^Fp,    Gs^Fp,    Gg^Vh,    Gg^Vh,       Hh,       Hh,    Gs^Fp,    Gs^Fp,       Ww,    Gs^Fp,    Gs^Fp,    Gs^Fp,    Gs^Fp,    Gs^Fp,       Re,       Gg,    Gs^Fp,    Gs^Fp,    Gs^Fp,    Gs^Fp,       Re,       Re,       Re,    Gs^Fp,    Gs^Fp
       Re,       Re,    Gs^Fp,    Gs^Fp,       Mm,       Hh,       Re,    Gs^Fp,    Gs^Fp,    Gs^Fp,    Gs^Fp,    Gs^Fp,    Gs^Fp,       Re,       Re,       Re,    Gs^Fp,    Gs^Fp,    Gs^Fp,    Gs^Fp,    Gs^Fp,    Gs^Fp,    Gs^Fp,    Gs^Fp,       Ww,       Ww,    Gs^Fp,    Gs^Fp,       Hh,    Gs^Fp,    Gs^Fp,       Re,       Gg,    Gs^Fp,    Gs^Fp,       Hh,    Gs^Fp,    Gs^Fp,    Gs^Fp,    Gs^Fp,    Gs^Fp,    Gs^Fp
    Gs^Fp,    Gs^Fp,    Gs^Fp,    Gs^Fp,       Mm,       Mm,    Gs^Fp,       Hh,       Mm,       Mm,    Gs^Fp,    Gs^Fp,    Gs^Fp,    Gs^Fp,       Re,    Gs^Fp,    Gs^Fp,    Gs^Fp,    Gs^Fp,    Gs^Fp,    Gs^Fp,    Gs^Fp,       Ww,       Ww,       Gg,    Gs^Fp,    Gs^Fp,    Gs^Fp,    Gg^Vh,       Hh,    Gs^Fp,       Re,       Re,       Gg,       Gg,    Gs^Fp,    Gs^Fp,    Gs^Fp,       Hh,       Hh,    Gs^Fp,    Gs^Fp
    Gs^Fp,    Gs^Fp,       Hh,       Mm,       Hh,       Gg,       Gg,       Gg,      Qxu,       Mm,       Hh,       Mm,       Mm,    Gs^Fp,    Gs^Fp,       Re,    Gs^Fp,    Gs^Fp,    Gs^Fp,    Gs^Fp,    Gs^Fp,    Gs^Fp,       Ww,    Gs^Fp,       Gg,       Gg,       Gg,       Gg,       Gg,       Gg,       Gg,       Gg,       Re,       Re,       Re,       Gg,    Gs^Fp,    Gs^Fp,    Gs^Fp,       Hh,    Gs^Fp,    Gs^Fp
    Gs^Fp,    Gs^Fp,       Mm,      Qxu,       Mm,    Gs^Fp,       Gg,    Gs^Fp,     4 Kh,      Qxu,      Qxu,       Mm,       Mm,    Gs^Fp,       Hh,       Hh,       Re,    Gs^Fp,    Gs^Fp,       Wo,    Gs^Fp,    Gs^Fp,       Ww,    Gs^Fp,    Gg^Vh,       Gg,       Gg,       Gg,       Hh,    Gs^Fp,       Re,       Re,    Gs^Fp,    Gs^Fp,    Gs^Fp,       Re,    Gs^Fp,    Gs^Fp,    Gs^Fp,    Gs^Fp,    Gs^Fp,    Gs^Fp
    Gs^Fp,    Gs^Fp,       Mm,      Qxu,      Qxu,       Mm,    Gs^Fp,       Ch,       Ch,       Ch,       Gg,      Qxu,       Mm,    Gs^Fp,    Gs^Fp,       Hh,       Re,    Gs^Fp,    Gs^Fp,    Gs^Fp,    Gs^Fp,    Gs^Fp,       Ww,    Gs^Fp,    Gs^Fp,    Gs^Fp,    Gs^Fp,       Hh,    Gs^Fp,    Gs^Fp,    Gs^Fp,    Gs^Fp,    Gs^Fp,    Gs^Fp,    Gs^Fp,    Gs^Fp,    Gs^Fp,       Re,       Re,    Gs^Fp,    Gs^Fp,    Gs^Fp
    Gs^Fp,    Gs^Fp,    Gs^Fp,       Mm,       Mm,       Mm,      Qxu,    Gs^Fp,    Gs^Fp,    Gs^Fp,      Qxu,      Qxu,       Mm,       Mm,    Gs^Fp,    Gs^Fp,       Re,    Gs^Fp,    Gs^Fp,    Gs^Fp,    Gs^Fp,    Gs^Fp,    Gs^Fp,       Ww,       Ww,    Gs^Fp,    Gs^Fp,    Gs^Fp,    Gs^Fp,       Re,    Gs^Fp,    Gs^Fp,       Gg,    Gs^Fp,    Gs^Fp,    Gs^Fp,    Gs^Fp,    Gs^Fp,       Re,    Gs^Fp,    Gs^Fp,    Gs^Fp
    Gs^Fp,    Gs^Fp,    Gs^Fp,    Gs^Fp,       Hh,       Mm,       Mm,      Qxu,       Mm,      Qxu,       Mm,       Mm,       Mm,    Gs^Fp,       Re,    Gs^Fp,    Gs^Fp,       Re,       Re,       Re,       Re,    Gs^Fp,    Gs^Fp,    Gs^Fp,    Gs^Fp,       Ww,    Gs^Fp,    Gs^Fp,    Gs^Fp,       Re,       Gg,       Gg,       Gg,       Gg,    Gs^Fp,    Gs^Fp,       Mm,    Gs^Fp,    Gs^Fp,       Re,       Re,       Re
    Gs^Fp,    Gs^Fp,    Gs^Fp,    Gs^Fp,    Gs^Fp,       Hh,       Hh,      Qxu,      Qxu,      Qxu,       Mm,       Mm,    Gs^Fp,    Gs^Fp,       Re,    Gs^Fp,    Gs^Fp,    Gs^Fp,    Gs^Fp,    Gs^Fp,    Gs^Fp,    Gs^Fp,       Re,    Gs^Fp,    Gs^Fp,       Ww,    Gs^Fp,    Gs^Fp,       Re,       Gg,       Gg,       Gg,    Gs^Fp,    Gs^Fp,       Mm,       Mm,       Gg,    Gs^Fp,       Gg,    Gs^Fp,    Gs^Fp,    Gs^Fp
    Gs^Fp,    Gs^Fp,       Gg,    Gs^Fp,    Gs^Fp,    Gs^Fp,    Gs^Fp,       Hh,       Hh,       Hh,    Gs^Fp,    Gs^Fp,    Gs^Fp,       Re,    Gs^Fp,    Gs^Fp,    Gs^Fp,       Hh,       Mm,       Hh,       Mm,    Gs^Fp,    Gs^Fp,       Re,    Gs^Fp,       Ww,    Gs^Fp,    Gs^Fp,       Re,       Gg,    Gs^Fp,    Gs^Fp,       Mm,       Mm,       Gg,       Mm,       Gg,       Gg,       Gg,       Mm,    Gs^Fp,    Gs^Fp
       Gg,       Gg,       Gg,    Gs^Fp,    Gs^Fp,    Gs^Fp,    Gs^Fp,    Gs^Fp,    Gs^Fp,    Gs^Fp,    Gs^Fp,    Gs^Fp,       Re,       Re,    Gs^Fp,       Hh,       Mm,       Mm,      Qxu,      Qxu,      Qxu,       Mm,       Hh,    Gs^Fp,    Gs^Fp,       Ww,       Ww,    Gs^Fp,    Gs^Fp,    Gs^Fp,    Gs^Fp,       Mm,       Mm,       Gg,       Gg,       Gg,       Gg,    Gs^Fp,       Mm,       Mm,    Gs^Fp,    Gs^Fp
    Gs^Fp,    Gs^Fp,    Gs^Fp,       Gg,    Gs^Fp,       Gg,    Gs^Fp,    Gs^Fp,    Gs^Fp,    Gs^Fp,       Re,    Gs^Fp,    Gs^Fp,    Gs^Fp,       Mm,       Mm,       Mm,      Qxu,       Re,       Re,      Qxu,       Mm,       Mm,       Hh,    Gs^Fp,    Gs^Fp,       Ww,    Gs^Fp,   Ss^Vhs,    Gs^Fp,    Gs^Fp,       Hh,       Mm,       Mm,       Mm,    Gs^Fp,    Gs^Fp,       Mm,       Mm,       Mm,       Mm,       Mm
    Gs^Fp,    Gs^Fp,    Gs^Fp,    Gs^Fp,       Gg,       Gg,    Gs^Fp,    Gs^Fp,       Re,       Re,    Gs^Fp,    Gs^Fp,    Gs^Fp,    Gs^Fp,    Gs^Fp,       Hh,       Mm,      Qxu,      Qxu,       Re,       Re,      Qxu,       Mm,       Mm,    Gs^Fp,    Gs^Fp,       Ww,       Ss,       Ss,       Ss,       Ss,    Gs^Fp,       Mm,    Gs^Fp,       Gg,       Gg,       Gg,       Mm,       Mm,       Mm,    Gs^Fp,    Gs^Fp
    Gs^Fp,    Gs^Fp,    Gs^Fp,       Gg,    Gs^Fp,       Gg,    Gs^Fp,       Re,    Gs^Fp,       Re,    Gs^Fp,    Gs^Fp,    Gs^Fp,    Gs^Fp,    Gs^Fp,       Mm,       Mm,       Mm,       Mm,      Qxu,       Re,       Hh,       Hh,       Hh,    Gs^Fp,    Gs^Fp,       Ww,    Gs^Fp,       Ss,       Mm,       Hh,       Hh,       Mm,       Mm,       Mm,       Mm,    Gs^Fp,    Gs^Fp,    Gs^Fp,       Mm,       Mm,       Mm
    Gs^Fp,    Gs^Fp,    Gs^Fp,    Gs^Fp,    Gs^Fp,    Gs^Fp,       Re,       Re,    Gs^Fp,       Re,       Re,    Gs^Fp,    Gg^Vh,    Gs^Fp,    Gs^Fp,    Gs^Fp,    Gs^Fp,    Gs^Fp,       Mm,      Qxu,       Mm,       Re,    Gs^Fp,    Gs^Fp,    Gs^Fp,    Gs^Fp,       Ww,    Gs^Fp,       Hh,       Mm,       Mm,       Hh,       Mm,      Qxu,      Qxu,       Gg,       Gg,       Gg,       Gg,       Mm,       Mm,       Mm
       Re,       Re,       Re,    Gs^Fp,       Re,    Gs^Fp,    Gs^Fp,    Gs^Fp,    Gs^Fp,    Gs^Fp,       Re,    Gs^Fp,    Gs^Fp,    Gs^Fp,    Gs^Fp,    Gs^Fp,    Gs^Fp,    Gs^Fp,    Gs^Fp,       Mm,    Gs^Fp,    Gs^Fp,       Ww,    Gs^Fp,       Ww,       Ww,       Ss,    Gs^Fp,    Gs^Fp,       Hh,       Mm,    Gs^Fp,    Gs^Fp,       Mm,      Qxu,       Gg,       Ch,       Ch,    Gs^Fp,      Qxu,       Mm,       Mm
    Gs^Fp,    Gs^Fp,       Hh,       Re,    Gs^Fp,    Gs^Fp,       Mm,    Gs^Fp,    Gs^Fp,    Gs^Fp,    Gs^Fp,       Re,       Re,    Gs^Fp,    Gs^Fp,    Gs^Fp,    Gg^Vh,    Gs^Fp,       Ss,    Gs^Fp,       Ww,       Ww,       Ss,       Ww,    Gs^Fp,    Gs^Fp,       Ss,       Ss,   Ss^Vhs,    Gs^Fp,    Gs^Fp,    Gs^Fp,       Mm,       Mm,      Qxu,       Ch,     5 Kh,       Ch,    Gs^Fp,       Mm,       Mm,       Mm
    Gs^Fp,    Gs^Fp,    Gg^Vh,       Re,       Hh,       Hh,       Hh,       Mm,       Mm,    Gs^Fp,    Gs^Fp,    Gs^Fp,    Gs^Fp,       Re,       Re,    Gs^Fp,    Gs^Fp,    Gs^Fp,       Ww,       Ww,       Ss,    Gs^Fp,    Gs^Fp,    Gs^Fp,    Gs^Fp,   Ss^Vhs,    Gs^Fp,    Gs^Fp,       Gg,       Gg,    Gs^Fp,       Hh,       Mm,      Qxu,    Gs^Fp,       Ch,       Ch,       Ch,    Gs^Fp,       Mm,       Hh,       Hh
    Gs^Fp,    Gs^Fp,       Re,       Re,       Re,    Gs^Fp,    Gg^Vh,       Hh,       Hh,       Mm,       Mm,    Gs^Fp,    Gs^Fp,    Gs^Fp,       Re,    Gs^Fp,    Gs^Fp,       Ww,    Gs^Fp,       Ss,   Ss^Vhs,    Gs^Fp,    Gs^Fp,    Gs^Fp,       Gg,    Gs^Fp,       Gg,    Gs^Fp,    Gs^Fp,       Gg,    Gs^Fp,       Mm,       Hh,      Qxu,       Mm,    Gs^Fp,    Gs^Fp,    Gs^Fp,       Mm,      Qxu,       Hh,       Hh
    Gs^Fp,    Gs^Fp,    Gs^Fp,       Gg,       Re,       Re,       Re,    Gs^Fp,       Hh,       Mm,       Mm,       Mm,    Gs^Fp,    Gs^Fp,    Gs^Fp,       Re,   Ww^Bw\,       Ww,    Gs^Fp,    Gs^Fp,    Gs^Fp,    Gs^Fp,    Gs^Fp,       Gg,       Hh,       Gg,       Gg,    Gs^Fp,    Gs^Fp,       Mm,       Hh,       Hh,      Qxu,       Mm,      Qxu,    Gs^Fp,      Qxu,      Qxu,      Qxu,      Qxu,       Mm,       Mm
    Gs^Fp,    Gs^Fp,    Gs^Fp,    Gg^Vh,    Gs^Fp,       Gg,       Gg,       Re,       Re,       Mm,       Mm,    Gs^Fp,       Ww,       Ww,       Ww,       Ww,    Gs^Fp,       Re,       Re,    Gs^Fp,    Gs^Fp,    Gs^Fp,       Gg,       Gg,       Gg,       Hh,       Gg,       Gg,    Gs^Fp,    Gs^Fp,       Hh,       Mm,       Mm,       Mm,       Mm,      Qxu,       Mm,       Mm,       Mm,       Mm,       Mm,       Mm
    Gs^Fp,    Gs^Fp,    Gs^Fp,    Gs^Fp,    Gs^Fp,       Gg,    Gs^Fp,       Gg,       Re,    Gg^Vh,       Hh,    Gs^Fp,       Ww,    Gs^Fp,    Gs^Fp,    Gs^Fp,    Gs^Fp,    Gg^Vh,    Gs^Fp,       Re,    Gs^Fp,       Gg,    Gs^Fp,    Gs^Fp,    Gs^Fp,       Gg,    Gs^Fp,    Gs^Fp,    Gs^Fp,    Gs^Fp,       Mm,       Mm,    Gs^Fp,    Gs^Fp,       Hh,       Mm,    Gs^Fp,       Mm,       Hh,       Mm,    Gs^Fp,    Gs^Fp
    Gs^Fp,    Gs^Fp,    Gs^Fp,    Gs^Fp,    Gs^Fp,       Gg,    Gs^Fp,       Gg,       Re,    Gg,       Hh,    Gs^Fp,       Ww,    Gs^Fp,    Gs^Fp,    Gs^Fp,    Gs^Fp,    Gg,    Gs^Fp,       Re,    Gs^Fp,       Gg,    Gs^Fp,    Gs^Fp,    Gs^Fp,       Gg,    Gs^Fp,    Gs^Fp,    Gs^Fp,    Gs^Fp,       Mm,       Mm,    Gs^Fp,    Gs^Fp,       Hh,       Mm,    Gs^Fp,       Mm,       Hh,       Mm,    Gs^Fp,    Gs^Fp
