Xu, Xu, Xu, Xu, Xu, Xu, Xu, Xu, Xu, Ds, Xu, Xu, Xu, Xu, Xu, Ds, Xu, Xu, Xu, Xu, Xu, Xu, Xu, Xu, Xu
Xu, Xu, Xu, Xu, Xu, Xu, Xu, Rr, Ds, Ds, Ds, Ds, Ds, Ds, Rr, Ds, Rr, Rr, Xu, Xu, Xu, Xu, Xu, Xu, Xu
Xu, Xu, Xu, Xu, Xu, Ds, Ds, Ds, Rr, Rr, Ds, Kud, Ds, Kud, Ds, Rr, Ds, Ds, Ds, Ds, Xu, Xu, Xu, Xu, Xu
Xu, Xu, Xu, Xu, Xu, Ds, Rr, Ds, Rr, Ds, Cud, Cud, 2 Kud, Cud, Cud, Ds, Ds, Rr, Ds, Ds, Xu, Xu, Xu, Xu, Xu
Xu, Xu, Xu, Xu, Xu, Ds, Ds, Rr, Ds, Ds, Ds, Ds, Cud, Ds, Ds, Rr, Ds, Rr, Ds, Ds, Xu, Xu, Xu, Xu, Xu
Xu, Xu, Xu, Xu, Xu, Rr, Ds, Ds, Rr, Rr, Ds, Rr, Ds, Rr, Ds, Rr, Ds, Ds, Rr, Ds, Xu, Xu, Xu, Xu, Xu
Xu, Xu, Xu, Xu, Xu, Xu, Rr, Ds, Rr, Ds, Rr, Ds, Rr, Ds, Ds, Ds, Ds, Ds, Rr, Xu, Xu, Xu, Xu, Xu, Xu
Xu, Xu, Xu, Xu, Xu, Xu, Ww, Ww, Ds, Rr, Ds, Ds, Ds, Ds, Rr, Ds, Ds, Ww, Ww, Xu, Xu, Xu, Xu, Xu, Xu
Xu, Xu, Xu, Xu, Xu, Ww, Ww, Ww, Xu, Xu, Ds, Rr, Ds, Ds, Ds, Xu, Xu, Ww, Ww, Ww, Xu, Xu, Xu, Xu, Xu
Xu, Xu, Xu, Wo, Wo, Ww, Ww, Xu, Xu, Xu, Xu, Rr, Rr, Rr, Xu, Xu, Xu, Xu, Ww, Ww, Wo, Wo, Xu, Xu, Xu
Xu, Xu, Xu, Wo, Ww, Ww, Xu, Xu, Xu, Xu, Ds, Ds, Rr, Rr, Rr, Xu, Xu, Xu, Xu, Ww, Ww, Wo, Xu, Xu, Xu
Xu, Xu, Xu, Wo, Ww, Ww, Ww, Xu, Xu, Xu, Ds, Rr, Ds, Rr, Ds, Xu, Xu, Xu, Ww, Ww, Ww, Wo, Xu, Xu, Xu
Xu, Xu, Xu, Xu, Xu, Ww, Ww, Xu, Xu, Rr, Ds, Ds, Rr, Rr, Rr, Rr, Xu, Xu, Ww, Ww, Xu, Xu, Xu, Xu, Xu
Xu, Xu, Xu, Xu, Xu, Ww, Ww, Rr, Ds, Rr, Rr, Rr, Rr, Rr, Ds, Rr, Rr, Ds, Ww, Ww, Xu, Xu, Xu, Xu, Xu
Xu, Xu, Xu, Xu, Rr, Rr, Ds, Ds, Rr, Ww, Ww, Ww, Rr, Ww, Ww, Ww, Ds, Rr, Rr, Ds, Rr, Rr, Xu, Xu, Xu
Xu, Xu, Xu, Xu, Ds, Ww, Ww, Ww, Wo, Wo, Wo, Wo, Wo, Wo, Wo, Wo, Wo, Wo, Ww, Ww, Rr, Xu, Xu, Xu, Xu
Xu, Xu, Xu, Ww, Ww, Wo, Wo, Wo, Wo, Wo, Wo, Wo, Wo, Wo, Wo, Wo, Wo, Wo, Wo, Wo, Ww, Ww, Xu, Xu, Xu
Xu, Xu, Xu, Rr, Ww, Ww, Ww, Ww, Ww, Ww, Ww, Ww, Ww, Ww, Ww, Ww, Ww, Ww, Ww, Ww, Ww, Rr, Xu, Xu, Xu
Xu, Xu, Xu, Xu, Rr, Rr, Ds, Rr, Rr, Ds, Rr, Ds, Rr, Rr, Ds, Rr, Rr, Rr, Ds, Rr, Rr, Xu, Xu, Xu, Xu
Xu, Xu, Xu, Xu, Xu, Xu, Xu, Rr, Rr, Ds, Rr, Rr, Ds, Ds, Rr, Rr, Rr, Rr, Xu, Xu, Xu, Xu, Xu, Xu, Xu
Xu, Xu, Xu, Xu, Xu, Xu, Rr, Ds, Rr, Ds, Rr, Ds, Rr, Rr, Ds, Ds, Ds, Ds, Rr, Xu, Xu, Xu, Xu, Xu, Xu
Xu, Xu, Xu, Xu, Xu, Xu, Rr, Rr, Rr, Rr, Rr, Cud, Rr, Cud, Rr, Rr, Rr, Ds, Rr, Xu, Xu, Xu, Xu, Xu, Xu
Xu, Xu, Xu, Xu, Xu, Xu, Xu, Ds, Ds, Rr, Rr, Cud, 1 Kud, Cud, Ds, Rr, Ds, Ds, Xu, Xu, Xu, Xu, Xu, Xu, Xu
Xu, Xu, Xu, Xu, Xu, Xu, Xu, Xu, Xu, Rr, Ds, Rr, Cud, Rr, Rr, Rr, Xu, Xu, Xu, Xu, Xu, Xu, Xu, Xu, Xu
Xu, Xu, Xu, Xu, Xu, Xu, Xu, Xu, Xu, Xu, Xu, Xu, Rr, Xu, Xu, Xu, Xu, Xu, Xu, Xu, Xu, Xu, Xu, Xu, Xu
