Gs^Fp,Gs^Fp,Gs^Fp,Gs^Fp,Gs^Fp,Gg^Ve,Gs^Fp,Gs^Fp,Gs^Fp,Gs^Fp,Gs^Fp,Gs^Fp,Gs^Fp,Gs^Fp,Gs^Fp,Gs^Fp,Gs^Fp,Gs^Fp,Gs^Fp,Gs^Fp,Gs^Fp,Gs^Fp,Gs^Fp,Gs^Fp,Gs^Fp,Gs^Fp,Gs^Fp,Gs^Fp,Gs^Fp,Gs^Fp,Gs^Fp,Gs^Fp,Gs^Fp,Gs^Fp,Gs^Fp,Re,Re,Gs^Fp,Gs^Fp,Gs^Fp
Gg,Gg,Gs^Fp,Gs^Fp,Gs^Fp,Gs^Fp,Gs^Fp,Gs^Fp,Gs^Fp,Gs^Fp,Gs^Fp,Gs^Fp,Gs^Fp,Gs^Fp,Gg^Ve,Gs^Fp,Gs^Fp,Gs^Fp,Gg,Gs^Fp,Gs^Fp,Gs^Fp,Gs^Fp,Gs^Fp,Gs^Fp,Gs^Fp,Gs^Fp,Gs^Fp,Gs^Fp,Gs^Fp,Gs^Fp,Gs^Fp,Gs^Fp,Gs^Fp,Gs^Fp,Re,Gg,Gs^Fp,Gs^Fp,Gs^Fp
Gg,Gs^Fp,Gs^Fp,Gs^Fp,Gs^Fp,Gs^Fp,Gs^Fp,Gs^Fp,Gs^Fp,Gs^Fp,Gs^Fp,Gs^Fp,Gs^Fp,Chr,Chr,Chr,Gs^Fp,Gs^Fp,Gg,Gs^Fp,Gs^Fp,Ce,Gs^Fp,Ce,Gg,Gg,Gg,Gg,Gs^Fp,Chr,Chr,Chr,Gs^Fp,Gs^Fp,Gs^Fp,Gs^Fp,Re,Re,Gs^Fp,Gg^Ve
Gs^Fp,Gs^Fp,Gs^Fp,Gs^Fp,Gg,Gg,Gs^Fp,Gs^Fp,Gs^Fp,Gs^Fp,Gs^Fp,Gs^Fp,Chr,Chr,3 Kh,Chr,Chr,Gs^Fp,Gs^Fp,Gs^Fp,Gg,Ce,Ce,Ce,Gs^Fp,Gs^Fp,Gs^Fp,Gg,Gs^Fp,Chr,6 Kh,Chr,Gs^Fp,Gs^Fp,Gs^Fp,Gs^Fp,Rr,Re,Gs^Fp,Gs^Fp
Gs^Fp,Gs^Fp,Gs^Fp,Gs^Fp,Gg,Gg,Gs^Fp,Gs^Fp,Gs^Fp,Chr,Chr,Chr,Chr,Chr,Chr,Chr,Gs^Fp,Gs^Fp,Gg,Gs^Fp,Ce,Ce,4 Kh,Ce,Ce,Gg^Ve,Gs^Fp,Gs^Fp,Gs^Fp,Chr,Chr,Chr,Gs^Fp,Gs^Fp,Gs^Fp,Re,Re,Gs^Fp,Gs^Fp,Gg
Gs^Fp,Gs^Fp,Gs^Fp,Gs^Fp,Gs^Fp,Gs^Fp,Gs^Fp,Gs^Fp,Gg,Chr,5 Kh,Chr,Chr,Chr,Gs^Fp,Gs^Fp,Gs^Fp,Gs^Fp,Gs^Fp,Gg,Gg,Ce,Ce,Ce,Gs^Fp,Gs^Fp,Gs^Fp,Gs^Fp,Gs^Fp,Gg^Ve,Gs^Fp,Gs^Fp,Gs^Fp,Gs^Fp,Gg,Re,Gg,Gg,Gg,Gg
Gs^Fp,Gs^Fp,Gs^Fp,Gs^Fp,Gs^Fp,Gs^Fp,Gs^Fp,Gs^Fp,Gs^Fp,Gg,Chr,Chr,Gs^Fp,Gs^Fp,Gs^Fp,Gs^Fp,Gg,Gs^Fp,Gg,Gg,Gg,Gs^Fp,Gs^Fp,Gs^Fp,Gg,Gs^Fp,Gs^Fp,Gs^Fp,Gs^Fp,Gs^Fp,Gs^Fp,Gs^Fp,Gg,Gg,Gg,Re,Re,Gg,Gg,Gg
Gs^Fp,Gs^Fp,Gs^Fp,Gs^Fp,Gs^Fp,Gs^Fp,Gs^Fp,Gs^Fp,Gs^Fp,Gg,Gg,Gs^Fp,Gs^Fp,Gs^Fp,Gs^Fp,Gs^Fp,Gg,Gs^Fp,Gg,Gg,Gs^Fp,Gs^Fp,Gs^Fp,Gg,Ss,Ss,Ss,Ss,Ss,Ss,Ss,Ss,Ss,Gs^Fp,Gg,Re,Gs^Fp,Gs^Fp,Gs^Fp,Gg
Gs^Fp,Gs^Fp,Gs^Fp,Gg,Gg,Gs^Fp,Gs^Fp,Gs^Fp,Gs^Fp,Gs^Fp,Gs^Fp,Gs^Fp,Gs^Fp,Gs^Fp,Gs^Fp,Gs^Fp,Gs^Fp,Gs^Fp,Gg,Gg,Gs^Fp,Gs^Fp,Ss,Ss,Ss,Ss^Vhs,Ss,Ss,Ss,Ss,Ss,Ss,Rr,Re,Re,Re,Gs^Fp,Mm,Mm,Mm
Gs^Fp,Gs^Fp,Gs^Fp,Gs^Fp,Gs^Fp,Gg^Ve,Gs^Fp,Gs^Fp,Gs^Fp,Gs^Fp,Gs^Fp,Gs^Fp,Gs^Fp,Gs^Fp,Gs^Fp,Gs^Fp,Gs^Fp,Gs^Fp,Gg,Ss,Ss,Ss,Ss,Chs,Chs,Chs,Chs,Chs,Ss,Ss,Ss,Ss,Re,Rr,Re,Ss,Mm,Mm,Mm,Mm
Gs^Fp,Gs^Fp,Gs^Fp,Gs^Fp,Gs^Fp,Gs^Fp,Gs^Fp,Gs^Fp,Gs^Fp,Gs^Fp,Gs^Fp,Gs^Fp,Ss,Ss,Ss,Ss,Ss,Ss,Ss,Ss,Ss,Ss,Chs,Chs,Ss,Re,Re,Ss,Ss,Ss,Chs,Chs,Re,Re,Chs,Ss,Hh,Mm,Mm,Mm
Gs^Fp,Gs^Fp,Gs^Fp,Gs^Fp,Gs^Fp,Gs^Fp,Gs^Fp,Gs^Fp,Gs^Fp,Gg,Gg,Ss,Ss,Ss^Vhs,Ss,Ss,Chs,Chs,Chs,Ss,Ss,Ss,Chs,Ss,Re,Re,Ss,Ss,Ss,Ss,Ss,Re,Rr,Re,Chs,Hh,Hh,Hh,Hh,Hh
Gs^Fp,Gs^Fp,Gs^Fp,Gs^Fp,Gs^Fp,Gs^Fp,Gs^Fp,Gs^Fp,Ss,Ss,Ss,Chs,Chs,Ss,Ss,Chs,Chs,Gg,Gg,Gg,Ss,Ss,Ss,Ss,Ss,Ss,Ss,Ss,Ss,Ss,Ss,Ss,Re,Re,Gg,Gg,Gs^Fp,Gs^Fp,Gs^Fp,Gg
Gs^Fp,Gs^Fp,Gs^Fp,Gs^Fp,Gg,Gg,Gg,Ss,Ss,Ss,Chs,Gg,Gg,Ss,Ss,Ss,Ss,Ss,Ss,Ss,Ss,Ss,Ss,Ss,Ww,Ww,Ss,Ss,Ss,Ss,Re,Rr,Re,Gs^Fp,Gs^Fp,Gg,Gg,Ds,Ds,Ds
Gs^Fp,Gs^Fp,Gs^Fp,Gs^Fp,Gg,Gg,Ss,Ss,Ss,Ss,Chs,Re,Re,Ss,Ss,Ss,Ss,Ss,Ss,Ss,Ss,Ww,Ww,Ww,Ww,Ww,Ww,Ww,Ww,Ww,Wwf,Re,Re,Gs^Fp,Ds,Ds,Ds,Ww,Ww,Ww
Gs^Fp,Gs^Fp,Gs^Fp,Gs^Fp,Gg,Gg,Ss,Chs,Ss,Ss,Ss,Ss,Ss,Ss,Ss,Ss,Ss^Vhs,Ss,Ww,Ww,Ww,Ww,Ww,Ww,Ww,Ww,Ww,Ww,Ww,Wwf,Wwf,Wwf,Ww,Ww,Ww,Ww,Ww,Ww^Vm,Ww,Ww
Gs^Fp,Gs^Fp,Gs^Fp,Gs^Fp,Gs^Fp,Ss,Chs,Chs,Ss,Ss^Vhs,Ss,Ss,Ss,Ss,Ss,Ss,Ww,Ww,Ww,Ww,Ww,Ww,Ww,Ww,Ww,Ww,Ww,Ww,Wwf,Wwf,Wwf,Wwf,Ww,Ww,Ww,Ww,Ww,Ww,Ww,Ww
Gs^Fp,Gs^Fp,Gs^Fp,Gs^Fp,Gs^Fp,Chr,Ss,Ss,Ss,Ss,Ss,Ss,Ss,Ss,Ww,Ww,Ww,Ww,Ww,Ww,Ww,Ds,Ds,Ds,Ww,Ww,Ww,Ww,Rr,Rr,Wwf,Ww,Ww,Ww,Ww^Vm,Ww,Ww,Hh,Hh,Mm
Gs^Fp,Gs^Fp,Gs^Fp,Gs^Fp,Chr,Gs^Fp,Gs^Fp,Gs^Fp,Ss,Ss,Ww,Ww,Ww,Ww,Ww,Ww,Ww,Ww,Ww,Ww,Gs^Fp,Gg^Ve,Gs^Fp,Gs^Fp,Gg,Gg,Gs^Fp,Rr,Rr,Rr,Gs^Fp,Ww,Ww,Ww,Ww,Ww,Ww,Ww,Hh,Mm
Gs^Fp,Gs^Fp,Gs^Fp,Chr,Gs^Fp,Gs^Fp,Gs^Fp,Gs^Fp,Ds,Ww,Ww,Ww,Ww,Ww,Ww,Ww,Ww,Ww,Gs^Fp,Gs^Fp,Gs^Fp,Ww,Gs^Fp,Gs^Fp,Gs^Fp,Gg,Ss,Rr,Rr,Ww,Gg,Gg,Ds,Ww,Ww,Ww^Vm,Ww,Ww,Hh,Hh
Gs^Fp,Gg^Ve,Gs^Fp,Gs^Fp,Gs^Fp,Gs^Fp,Gs^Fp,Gs^Fp,Gs^Fp,Ww,Ww,Ww,Ww,Ww,Ww,Ds,Ds,Gg,Gs^Fp,Ww,Ww,Chw,Chw,Chr,Chw,Ww,Gs^Fp,Rr,Rr,Gg,Gg,Gg,Gs^Fp,Gs^Fp,Ww,Ww,Ww,Ww,Gs^Fp,Gs^Fp
Gs^Fp,Gs^Fp,Gs^Fp,Gs^Fp,Gs^Fp,Gs^Fp,Gs^Fp,Gs^Fp,Ww,Ww,Ww,Ww,Ww,Ds,Gg^Ve,Gg,Gg,Chw,Chw,Ww,Ww,Ww,Kh,Ww,Ww,Wwf,Wwf,Wwf,Rr,Gs^Fp,Gg,Gg,Ds,Ww,Ww,Ww,Ww,Ww,Gs^Fp,Gs^Fp
Gs^Fp,Gs^Fp,Gs^Fp,Gs^Fp,Gs^Fp,Gs^Fp,Gg^Ve,Wwf,Ww,Ww,Ww,Ww,Ds,Gg,Gg,Gg,Chr,Ww,Ww,Ww,Ww,Gs^Fp,Gs^Fp,Gs^Fp,Wwf,Wwf,Wwf,Ww,Chw,Chw,Gg,Gg,Ds,Gs^Fp,Ww,Ww,Ww,Ww,Ww,Gs^Fp
Gs^Fp,Gs^Fp,Gs^Fp,Gs^Fp,Gs^Fp,Gs^Fp,Gs^Fp,Wwf,Wwf,Wwf,Wwf,Ce,Ce,Ce,Gs^Fp,Gg,Chw,Ww,Ww,Gs^Fp,Gs^Fp,Chr,Chr,Chr,Chr,Wwf,Wwf,Ww,Ww,Chr,Gs^Fp,Gs^Fp,Gs^Fp,Ww,Ww,Ww,Ww,Gs^Fp,Gs^Fp,Gs^Fp
Gs^Fp,Gs^Fp,Gs^Fp,Gs^Fp,Gs^Fp,Gs^Fp,Wwf,Wwf,Wwf,Wwf,Wwf,Ce,1 Kh,Ce,Gs^Fp,Gs^Fp,Chr,Ww,Ww,Gs^Fp,Chr,Chr,Chr,2 Kh,Chr,Chr,Gs^Fp,Ww,Ww,Chw,Gs^Fp,Gg^Ve,Gs^Fp,Gs^Fp,Ww,Ww,Ww,Ww,Gs^Fp,Gs^Fp
Gs^Fp,Re,Gs^Fp,Gs^Fp,Gs^Fp,Ds,Ww,Ww,Ww,Ww,Wwf,Ce,Ce,Ce,Gg^Ve,Gs^Fp,Gs^Fp,Ww,Ww,Gs^Fp,Chr,Chr,Chr,Chr,Chr,Chr,Gs^Fp,Ww,Ww,Ww,Gs^Fp,Gs^Fp,Gs^Fp,Ww,Ww,Gs^Fp,Ww,Ww,Gs^Fp,Gs^Fp
Gs^Fp,Gg,Gg,Gs^Fp,Ds,Ww,Ww,Ww,Ww,Ww,Ww,Gg,Gg,Gs^Fp,Gs^Fp,Gs^Fp,Ww,Ww,Ww,Ww,Gs^Fp,Gs^Fp,Chr,Chr,Chr,Chr,Gs^Fp,Ww,Ww,Ww,Gs^Fp,Gs^Fp,Gs^Fp,Ww,Ww,Ww,Ww,Ww,Gs^Fp,Gs^Fp
Gs^Fp,Gg,Gs^Fp,Ds,Ww,Ww,Ww^Vm,Ww,Ww,Ww,Gs^Fp,Gs^Fp,Gg,Gg,Gs^Fp,Gs^Fp,Chw,Kh,Ww,Ww,Ww,Wwf,Wwf,Chr,Chr,Gs^Fp,Gs^Fp,Ww,Ww,Ww,Gs^Fp,Gs^Fp,Gs^Fp,Gs^Fp,Ww,Ww,Ww,Gs^Fp,Gs^Fp,Gs^Fp
Gg,Gg,Gg,Ww,Ww,Ww,Ww,Ww,Ww,Ww,Ww,Gs^Fp,Gg,Gg,Gg,Gs^Fp,Chw,Chw,Gs^Fp,Gs^Fp,Ww,Wwf,Wwf,Wwf,Gs^Fp,Ww,Ww,Ww,Kh,Chw,Gs^Fp,Gs^Fp,Ds,Ww,Ww,Ww,Ww,Ww,Gs^Fp,Gs^Fp
Gg,Gg,Gs^Fp,Ww,Ww,Ww,Ww,Ww,Ww,Ww,Ww,Ww,Gs^Fp,Gg,Gs^Fp,Gs^Fp,Gs^Fp,Gs^Fp,Ww,Chr,Ww,Wwf,Wwf,Wwf,Ww,Ww,Ww,Chr,Chr,Gs^Fp,Gs^Fp,Gs^Fp,Gs^Fp,Ds,Ww,Ww,Ww,Gg,Gg,Gs^Fp
Gs^Fp,Gs^Fp,Gs^Fp,Ww,Ww,Ww,Ww,Ww,Ww,Ww,Ww,Ww,Ww,Gs^Fp,Gs^Fp,Gs^Fp,Gs^Fp,Gg,Gs^Fp,Gg,Chw,Chw,Chw,Chw,Ww,Ww,Gs^Fp,Gs^Fp,Gs^Fp,Gs^Fp,Gs^Fp,Gs^Fp,Ds,Ww,Ww,Ww,Ww,Gs^Fp,Gs^Fp,Gs^Fp
Gs^Fp,Gs^Fp,Ww,Ww,Ww,Ww,Ww,Ds,Ds,Ww,Ww,Ww,Ww,Ww,Gg^Ve,Gs^Fp,Gs^Fp,Gg,Gs^Fp,Ww,Gs^Fp,Rr,Rr,Rr,Gs^Fp,Gs^Fp,Gs^Fp,Ww,Gs^Fp,Gs^Fp,Gs^Fp,Ww,Ww,Ww,Ww,Gs^Fp,Gs^Fp,Gs^Fp,Gs^Fp,Gs^Fp
Ww,Ww,Ww,Ww,Ww,Ww,Gs^Fp,Gs^Fp,Gs^Fp,Gs^Fp,Ww,Ww,Ww,Ww,Ww,Ww,Ds,Ww,Ww,Ww,Wwf,Rr,Rr,Gs^Fp,Ds,Ww,Ww,Ww,Ww,Ww,Ww,Ww,Ww,Ww,Gs^Fp,Gs^Fp,Gs^Fp,Gs^Fp,Gs^Fp,Gs^Fp
Ww,Ww,Ww,Gs^Fp,Gs^Fp,Gs^Fp,Gs^Fp,Gs^Fp,Gs^Fp,Gs^Fp,Gs^Fp,Ds,Ww,Ww,Ww,Ww,Ww,Ww,Ww,Ww,Wwf,Wwf,Wwf,Ww,Ww,Ww,Ww,Ww^Vm,Ww,Ww,Ww,Ww,Ww,Ww,Gs^Fp,Gs^Fp,Gs^Fp,Gg^Ve,Chr,Gs^Fp
Ww,Ww,Gs^Fp,Ss,Ss,Gs^Fp,Gs^Fp,Gs^Fp,Gs^Fp,Gs^Fp,Gs^Fp,Gg,Gg,Gg,Ww,Gs^Fp,Gs^Fp,Ww,Ww,Wwf,Wwf,Wwf,Ww,Ww,Ww,Ww,Ww,Ww,Ww,Ww,Ww,Gg,Gs^Fp,Gg,Gs^Fp,Gs^Fp,Chr,Chr,Chr,Gs^Fp
Chr,Chr,Chr,Gs^Fp,Gs^Fp,Gs^Fp,Gs^Fp,Gs^Fp,Gs^Fp,Gg,Gg,Gg,Gg,Ss,Gs^Fp,Gs^Fp,Gs^Fp,Gg,Ww,Wwf,Wwf,Wwf,Ww,Ww,Ww,Ww,Ww,Gs^Fp,Gs^Fp,Ww,Gs^Fp,Gg,Ds,Ww,Gs^Fp,Chr,Gg,Gg,Gg,Hh
Gs^Fp,Gs^Fp,Chr,Chr,Gs^Fp,Gs^Fp,Gg,Gs^Fp,Gs^Fp,Gg,Gg,Gs^Fp,Ss,Ss,Gs^Fp,Gs^Fp,Gg,Gg,Gg,Rr,Rr,Gs^Fp,Gs^Fp,Gs^Fp,Gs^Fp,Gs^Fp,Gs^Fp,Gs^Fp,Gs^Fp,Gs^Fp,Gg,Gg,Gg,Gs^Fp,Gs^Fp,Gs^Fp,Gg,Gg,Gg,Gg
Gs^Fp,Gs^Fp,Gs^Fp,Gs^Fp,Gs^Fp,Gs^Fp,Gs^Fp,Gs^Fp,Chr,Chr,Chr,Ss,Gs^Fp,Gs^Fp,Gs^Fp,Gs^Fp,Gg,Chr,Re,Rr,Chr,Gg,Gg,Gg,Gs^Fp,Gs^Fp,Gs^Fp,Gs^Fp,Gs^Fp,Gs^Fp,Chr,Chr,Chr,Gs^Fp,Gs^Fp,Gs^Fp,Gg,Gg,Gs^Fp,Gg
Gs^Fp,Gs^Fp,Gg,Gs^Fp,Gs^Fp,Gs^Fp,Gs^Fp,Gs^Fp,Gs^Fp,Gs^Fp,Chr,Chr,Ss,Gs^Fp,Gs^Fp,Gg,Chr,Chr,Rr,Re,Chr,Chr,Gg,Gs^Fp,Gs^Fp,Gs^Fp,Gs^Fp,Gs^Fp,Chr,Chr,Gg,Gg,Gg,Gs^Fp,Gg,Gs^Fp,Gs^Fp,Gs^Fp,Gg,Gg
Gg,Gs^Fp,Gg,Gs^Fp,Gs^Fp,Gs^Fp,Gs^Fp,Gs^Fp,Gs^Fp,Gs^Fp,Gs^Fp,Gg,Gs^Fp,Gs^Fp,Gs^Fp,Gg,Gg,Gg,Rr,Re,Gg,Gg,Gs^Fp,Gg^Ve,Gs^Fp,Gs^Fp,Gs^Fp,Gs^Fp,Gs^Fp,Gg,Gg,Gg,Gg,Gg,Gs^Fp,Gs^Fp,Gs^Fp,Gs^Fp,Gs^Fp,Gg