Gg^Vh,Gs^Fp,Gs^Fp,Hh,Ss,Ss,Ss,Ss,Ss,Ss,Ss,Ss,Gs^Fp,Ss^Vhs,Re,Gs^Fp,Gs^Fp,Gs^Fp,Gg^Vh,Re,Ss,Chr,Hh,Hh,Re,Mm,Mm,Hh,Hh,Gs^Fp,Hh,Hh,Hh,Ss,Ss,Ss,Ss,Ss,Ss,Ww
Gs^Fp,Gs^Fp,Ss,Ss,Ss,Ss,Ss,Ss,Gs^Fp,Gs^Fp,Gs^Fp,Gs^Fp,Ss,Ss,Re,Re,Gs^Fp,Gg,Re,Ss,Ss,Ss,Re,Re,Chr,Hh,Mm,Mm,Hh,Hh,Gs^Fp,Hh,Hh,Ss,Ss,Ss,Ss,Ss,Ss,Ww
Gs^Fp,Gs^Fp,Gs^Fp,Gs^Fp,Gs^Fp,Ss,Ss,Gs^Fp,Gs^Fp,Gs^Fp,Gs^Fp,Gs^Fp,Gs^Fp,Ss,Gs^Fp,Re,Re,Hh,Gs^Fp,Ss,Ss^Vhs,Ss,Gs^Fp,Gs^Fp,Gs^Fp,Ss^Vhs,Ss,Hh,Hh,Gs^Fp,Gs^Fp,Gs^Fp,Ss,Ss,Ss,Ss,Ss,Ss,Ss,Ss
Gs^Fp,Ce,Ce,Ce,Gs^Fp,Gs^Fp,Gs^Fp,Gs^Fp,Gg^Vh,Ss,Gs^Fp,Gs^Fp,Gs^Fp,Gs^Fp,Ss,Gg,Hh,Hh,Mm,Hh,Hh,Gs^Fp,Gs^Fp,Gs^Fp,Gs^Fp,Ss,Ss,Ss,Gs^Fp,Hh,Hh,Gs^Fp,Ss,Ss,Ss,Gs^Fp,Gs^Fp,Gs^Fp,Ss,Ss
Gs^Fp,Ce,3 Kh,Ce,Gs^Fp,Gs^Fp,Gs^Fp,Gs^Fp,Ss,Ss,Gs^Fp,Gs^Fp,Gs^Fp,Ss,Gs^Fp,Gg,Hh,Mm,Mm,Mm,Hh,Gs^Fp,Gs^Fp,Gs^Fp,Gs^Fp,Gs^Fp,Ss,Ss,Gs^Fp,Hh,Hh,Gs^Fp,Ss,Ss,Ss,Ss,Ss,Ss,Ss,Ss
Gs^Fp,Ce,Ce,Ce,Gs^Fp,Gs^Fp,Gs^Fp,Ss,Ss,Ss,Gs^Fp,Gs^Fp,Ss,Ss,Ss^Vhs,Re,Mm,Mm,Mm,Mm,Mm,Hh,Gs^Fp,Gs^Fp,Gs^Fp,Gs^Fp,Gs^Fp,Ss,Ss,Hh,Hh,Gs^Fp,Gs^Fp,Ss,Ss,Ss,Gs^Fp,Ss,Ss,Ss
Gs^Fp,Gs^Fp,Gs^Fp,Gs^Fp,Gs^Fp,Gs^Fp,Gs^Fp,Ss,Ss,Ss,Gs^Fp,Gs^Fp,Ss,Chr,Gg,Hh,Mm,Mm,Mm,Mm,Mm,Hh,Gs^Fp,Ss,Ss,Ss,Ss,Ss,Hh,Hh,Gg,Gg,Gg,Ss,Ss,Ss,Gs^Fp,Gs^Fp,Ss,Gs^Fp
Ss,Ss,Gs^Fp,Gs^Fp,Gs^Fp,Gg,Gs^Fp,Ss,Gs^Fp,Gs^Fp,Gs^Fp,Ss,Ss,Ww^Bw|,Ss,Hh,Mm,Mm,Mm,Mm,Mm,Hh,Ss,Ss,Ss,Ss,Ss,Ss,Ss,Hh,Gg,Gg,Gg,Ss,Ss,Ss,Ss,Ss,Ss,Gs^Fp
Ss,Ss,Ss,Gs^Fp,Gs^Fp,Gs^Fp,Gg,Ss,Ss,Ss,Ss,Ss,Ss,Re,Ss,Hh,Hh,Hh,Hh,Hh,Gs^Fp,Gs^Fp,Ss,Gs^Fp,Gs^Fp,Gs^Fp,Gs^Fp,Ss,Ss,Hh,Hh,Gg,Ss,Ss,Ss,Ss,Ss,Ss,Gs^Fp,Gs^Fp
Ss,Ss,Ss,Gs^Fp,Gg^Vh,Gs^Fp,Gs^Fp,Gs^Fp,Gs^Fp,Gs^Fp,Gs^Fp,Re,Re,Gs^Fp,Ss,Hh,Ss,Hh,Ss,Gs^Fp,Gs^Fp,Ss,Ss,Gs^Fp,Gg^Vh,Mm,Gs^Fp,Ss,Ss,Hh,Hh,Hh,Ss,Gs^Fp,Ss,Ss,Ss,Gs^Fp,Gs^Fp,Gs^Fp
Ss,Ss,Ss,Gs^Fp,Gs^Fp,Gs^Fp,Gs^Fp,Gs^Fp,Gs^Fp,Gs^Fp,Gs^Fp,Gg,Gs^Fp,Gs^Fp,Gs^Fp,Ss,Ss,Ss,Ss,Gs^Fp,Ss,Ss,Ss,Mm,Mm,Xu,Mm,Mm,Ss,Hh,Mm,Mm,Mm,Gs^Fp,Gs^Fp,Gs^Fp,Gs^Fp,Gs^Fp,Gs^Fp,Gs^Fp
Gs^Fp,Gs^Fp,Gs^Fp,Gs^Fp,Gs^Fp,Gs^Fp,Gs^Fp,Gg,Gg,Re,Re,Gs^Fp,Gs^Fp,Gs^Fp,Gs^Fp,Ss,Ss,Ss,Ss,Ss,Ss,Rr,Rr,Rr,Xu,Chr,Xu,Xu,Mm,Mm,Mm,Xu,Mm,Mm,Gs^Fp,Gs^Fp,Gs^Fp,Gs^Fp,Gs^Fp,Gs^Fp
Gs^Fp,Gs^Fp,Gs^Fp,Gs^Fp,Gs^Fp,Gs^Fp,Gs^Fp,Gg,Re,Gs^Fp,Gs^Fp,Hh,Mm,Mm,Hh,Hh,Ss,Ss^Vhs,Ss,Rr,Rr,Ss,Mm,Xu,Rr,Rr,Uu,Uu,Xu,Xu,Xu,Uu^Vu,Xu,Mm,Gs^Fp,Hh,Hh,Hh,Hh,Gs^Fp
Gs^Fp,Gs^Fp,Gs^Fp,Gs^Fp,Gs^Fp,Gs^Fp,Gs^Fp,Re,Gg^Vh,Gs^Fp,Gs^Fp,Mm,Mm,Mm,Hh,Gg,Ss,Ss,Rr,Hh,Hh,Mm,Xu,Uu,Chr,Uu,Rr,Rr,Chr,Chr,Uu,Uu,Xu,Mm,Hh,Hh,Hh,Hh,Mm,Mm
Gs^Fp,Gs^Fp,Gs^Fp,Gs^Fp,Ss,Ss,Gs^Fp,Re,Chr,Gs^Fp,Hh,Mm,Mm,Mm,Hh,Ss,Ss,Ss,Rr,Mm,Mm,Mm,Xu,Uu,Uu,Uu,Chr,Rr,Rr,Rr,Chr,Uu,Xu,Mm,Hh,Hh,Hh,Mm,Mm,Mm
Gg^Vh,Gs^Fp,Gs^Fp,Gs^Fp,Gs^Fp,Ss,Chr,Gs^Fp,Rr,Rr,Hh,Hh,Hh,Hh,Hh,Ss,Ss,Rr,Rr,Hh,Mm,Mm,Xu,Uu^Vu,Uu,Uu,Chr,Rr,Rr,Rr,Chr,Uu,Xu,Mm,Ss,Gg,Gg,Mm,Mm,Mm
Hh,Gs^Fp,Gs^Fp,Gs^Fp,Gs^Fp,Gs^Fp,Ss,Ss,Gs^Fp,Gs^Fp,Chr,Chr,Gg^Vh,Gs^Fp,Gs^Fp,Rr,Rr,Ss,Ss,Hh,Hh,Mm,Xu,Xu,Uu,Uu,Chr,Chr,Rr,Chr,Chr,Xu,Xu,Mm,Ss,Ss,Gg,Hh,Mm,Mm
Mm,Hh,Hh,Gs^Fp,Gs^Fp,Gs^Fp,Ss,Ss,Ss,Chr,Chr,Chr,Chr,Rr,Rr,Ss,Gs^Fp,Ss,Ss,Ss,Ss,Hh,Hh,Mm,Xu,Xu,Uu,Uu,Chr,Uu,Uu,Xu,Mm,Ss,Ss,Ss,Ss,Ss,Ss,Hh
Mm,Mm,Hh,Hh,Ss,Ss,Ss,Ss,Ss,Chr,Chr,Kh,Chr,Chr,Gs^Fp,Ss,Ss,Ss^Vhs,Ss,Ss,Ss,Ss,Hh,Mm,Ss^Vhs,Xu,Uu,Xu,Uu,Uu,Uu^Vu,Xu,Mm,Ss,Ss,Ss,Ss,Ss,Ss,Hh
Mm,Mm,Mm,Hh,Ss,Ss,Ss,Gs^Fp,Gs^Fp,Rr,Chr,Chr,Chr,Chr,Ss,Ss,Gs^Fp,Ss,Ss,Ss,Ss,Ss,Ss,Ss,Ss,Mm,Xu,Mm,Xu,Xu,Xu,Mm,Mm,Ss,Ss,Ss,Ss,Ss,Hh,Mm
Mm,Mm,Hh,Hh,Ss,Ss,Chr,Rr,Rr,Ss,Ss,Chr,Chr,Rr,Ss,Gs^Fp,Gs^Fp,Ss,Ss,Ss,Ss,Ss,Ss,Ss,Hh,Gs^Fp,Mm,Mm,Hh,Mm,Mm,Mm,Gs^Fp,Ss,Ss,Gs^Fp,Ss,Hh,Mm,Mm
Mm,Mm,Hh,Hh,Ss,Ss,Re,Chr,Gg,Gg^Vh,Gg,Ss,Ss,Ss,Rr,Rr,Gs^Fp,Ss,Ss,Ss,Ss,Ss,Ss,Ss,Ss,Hh,Hh,Gs^Fp,Hh,Hh,Gs^Fp,Gs^Fp,Gs^Fp,Gs^Fp,Gs^Fp,Gs^Fp,Hh,Hh,Mm,Mm
Hh,Hh,Hh,Hh,Ss,Ww^Bw/,Re,Ss,Ss,Ss,Ss,Ss,Ss,Ss,Ss,Rr,Chr,Ss,Ss,Ss,Ss,Ss,Ss,Ss,Ss^Vhs,Ss,Ss,Hh,Hh,Hh,Gs^Fp,Gs^Fp,Gs^Fp,Gs^Fp,Gs^Fp,Gs^Fp,Gs^Fp,Hh,Mm,Mm
Hh,Re,Ss^Vhs,Ww^Bw/,Ww^Bw/,Ss,Gs^Fp,Gs^Fp,Ss,Ss,Ss,Ss,Ss,Ss,Chr,Ss,Ww^Bw\,Rr,Ss,Ss,Ss,Ss,Ss,Ss,Ss,Ss,Ss,Ss,Hh,Hh,Gs^Fp,Gs^Fp,Gs^Fp,Gs^Fp,Gs^Fp,Ss,Ss,Hh,Mm,Mm
Re,Ce,Gg,Ss,Ss,Ss,Gs^Fp,Gs^Fp,Gs^Fp,Ss,Ss,Ss,Ss,Ss,Ss,Ss,Ss,Ww^Bw|,Gs^Fp,Ss,Ss,Ss,Ss,Ss,Ss,Ss,Ss,Hh,Hh,Hh,Gs^Fp,Gs^Fp,Gs^Fp,Gs^Fp,Gs^Fp,Gs^Fp,Ss,Hh,Hh,Hh
Ce,1 Kh,Ce,Ss,Ss,Ss,Gs^Fp,Ss,Ss,Ss,Ss,Ss,Ss,Ss,Ss,Gs^Fp,Ss^Vhs,Rr,Ss,Ss,Ss,Ss,Ss,Ss,Ss,Hh,Hh,Hh,Hh,Gs^Fp,Gs^Fp,Ss^Vhs,Ss,Ss,Gs^Fp,Gs^Fp,Gs^Fp,Ss,Gs^Fp,Hh
Ce,Ce,Ce,Gs^Fp,Ss,Ss,Ss,Ss,Ss,Ss,Ss,Ss,Ss,Ss,Ss,Ss,Gs^Fp,Rr,Ss^Vhs,Ss,Ss,Ss,Ss,Ss,Ss,Hh,Hh,Hh,Gs^Fp,Gs^Fp,Gs^Fp,Ss,Ss,Ss,Gs^Fp,Gs^Fp,Gs^Fp,Gs^Fp,Gs^Fp,Hh
Ss,Ss,Gs^Fp,Gs^Fp,Gs^Fp,Ss,Ss,Ss,Ss,Ss,Ss,Ss,Ss,Ss,Ss,Gs^Fp,Ss,Ww^Bw|,Ss,Ss,Ss,Ss,Ss,Ss,Ss,Hh,Hh,Gs^Fp,Gs^Fp,Gs^Fp,Gs^Fp,Ss,Ss,Ss,Gs^Fp,Gs^Fp,Gs^Fp,Gs^Fp,Gs^Fp,Hh
Ss,Ss,Gs^Fp,Gs^Fp,Gs^Fp,Ss,Ss,Ss,Ss,Ss,Ss,Ss,Ss,Ss,Ss,Ss,Ss,Rr,Chr,Ss,Ss,Ss,Ss,Ss,Ss,Ss,Ss,Gs^Fp,Gs^Fp,Ss,Ss,Ss,Ss,Gs^Fp,Gs^Fp,Gs^Fp,Gs^Fp,Gs^Fp,Gs^Fp,Hh
Ss,Ss,Gs^Fp,Gs^Fp,Gs^Fp,Gs^Fp,Ss,Ss,Gs^Fp,Ss,Ss,Ss,Ss,Ss,Ss,Ss,Ss,Chr,Ww^Bw\,Rr,Rr,Ww^Bw\,Ss,Ss,Ss,Ss,Ss,Ss,Ss,Ss,Ss,Ss,Ss,Ss,Ss,Gs^Fp,Gs^Fp,Gg^Vh,Gs^Fp,Hh
Hh,Gs^Fp,Gs^Fp,Hh,Gs^Fp,Gs^Fp,Ss,Ss,Gs^Fp,Ss,Ss,Ss,Ss,Gs^Fp,Gs^Fp,Ss,Ss,Ss,Ss,Ww^Bw|,Ss,Gg,Rr,Rr,Ss,Ss,Ss,Gs^Fp,Ss,Ss,Ss,Ss,Ss,Ss,Gs^Fp,Gs^Fp,Hh,Hh,Hh,Hh
Ss,Ss,Gs^Fp,Gs^Fp,Gs^Fp,Ss,Ss,Ss,Ss,Ss,Ss,Ss,Gs^Fp,Gs^Fp,Gs^Fp,Ss,Ss,Gs^Fp,Gs^Fp,Re,Hh,Hh,Gs^Fp,Gs^Fp,Ww^Bw\,Ww^Bw\,Gs^Fp,Gs^Fp,Ss,Ss,Gs^Fp,Ss,Ss,Ss,Gs^Fp,Mm,Mm,Mm,Mm,Mm
Gs^Fp,Gs^Fp,Gs^Fp,Ss,Ss,Ss,Ss,Ss,Ss,Ss,Ss,Ss,Ss,Gs^Fp,Ss,Gs^Fp,Gs^Fp,Gg^Vh,Gg,Hh,Mm,Hh,Gs^Fp,Gs^Fp,Ss,Ss,Ww^Bw\,Chr,Ss,Ss^Vhs,Gs^Fp,Gs^Fp,Ss,Ss,Hh,Mm,Mm,Mm,Mm,Mm
Gs^Fp,Gs^Fp,Gs^Fp,Ss,Ss,Ss,Ss,Gs^Fp,Gs^Fp,Gs^Fp,Ss,Ss,Ss,Ss,Ss,Gs^Fp,Gs^Fp,Gg,Re,Hh,Hh,Hh,Ss,Ss,Ss,Ss,Ss,Ww^Bw|,Ss,Ss,Ss,Ss,Gs^Fp,Ss,Ss,Mm,Mm,Mm,Mm,Mm
Gs^Fp,Gs^Fp,Gs^Fp,Ss,Ss,Ss,Gs^Fp,Gs^Fp,Gs^Fp,Gs^Fp,Ss,Ss,Ss,Ss,Ss,Gs^Fp,Gg,Gs^Fp,Ss,Ss,Ss,Hh,Ss,Ss,Ss,Ss,Ss,Chr,Ss,Ss,Ss,Gs^Fp,Gs^Fp,Gs^Fp,Hh,Mm,Mm,Mm,Mm,Mm
Gs^Fp,Gs^Fp,Ss,Ss,Gs^Fp,Ss,Ss,Ss,Ss,Ss,Ss,Ss,Ss,Ss,Ss,Gs^Fp,Re,Ss,Ss,Ss,Ss,Ss,Ss,Ss,Gs^Fp,Ss,Ss,Ss,Ww^Bw\,Ww^Bw\,Gs^Fp,Rr,Gs^Fp,Ce,Gs^Fp,Mm,Mm,Mm,Mm,Mm
Gs^Fp,Ss,Ss,Ss,Gs^Fp,Ss,Ss,Ss,Gs^Fp,Gs^Fp,Ss,Ss,Ss,Ss,Ss,Re,Gg,Ss,Ss,Ss,Ss,Ss,Ss,Gs^Fp,Gs^Fp,Gs^Fp,Ss,Ss,Gs^Fp,Gs^Fp,Rr,Gs^Fp,Ce,2 Kh,Ce,Hh,Hh,Hh,Hh,Mm
Gs^Fp,Gs^Fp,Ss,Ss,Ss,Ss,Ss,Ss,Gs^Fp,Gs^Fp,Ss,Gg,Gg,Chr,Ww^Bw/,Ss,Gs^Fp,Ss,Ss,Ss,Ss,Ss,Ss,Ss,Ss,Ss,Ss,Ss,Gs^Fp,Gs^Fp,Gs^Fp,Gs^Fp,Ce,Ce,Ce,Rr,Rr,Rr,Ss,Hh
Gs^Fp,Ss,Ss,Ss,Ss,Ss,Ss,Ss,Gs^Fp,Gs^Fp,Re,Ss,Ss,Ss,Ss,Gs^Fp,Gs^Fp,Gs^Fp,Ss,Ss,Ss,Ss,Ss,Ss,Ss,Ss,Ss,Ss,Ss,Gs^Fp,Gs^Fp,Gs^Fp,Gs^Fp,Gs^Fp,Chr,Hh,Gg,Gg,Ww^Bw\,Chr
Ss,Ss,Ss,Ss,Ss,Gs^Fp,Gs^Fp,Gs^Fp,Gs^Fp,Gg,Re,Gs^Fp,Ss,Gs^Fp,Ss,Ss,Gs^Fp,Gs^Fp,Ww,Ww,Ss,Ss,Ss,Ss,Ss,Gg,Ss,Ss,Hh,Ss,Gs^Fp,Gs^Fp,Gs^Fp,Gg^Vh,Re,Hh,Ss,Ss,Ss,Ss