Mm,Mm,Mm,Mm,Mm,Mm,Mm,Mm,Mm,Mm,Mm,Mm,Mm,Mm,Mm,Mm,Mm,Mm,Mm,Mm,Mm,Mm,Mm,Mm,Mm,Mm,Mm,Mm,Mm,Mm,Mm,Mm,Mm,Mm,Mm,Mm,Mm,Mm,Mm,Mm,Mm,Mm,Mm,Mm,Mm,Mm,Mm,Mm,Mm,Mm,Mm,Mm,Mm,Mm,Mm,Mm,Mm,Mm,Mm,Mm,Mm,Mm,Mm,Mm,Mm,Mm,Mm,Mm,Mm,Mm,Mm,Mm,Mm,Mm,Mm,Mm,Mm,Mm,Mm,Mm
Mm,Mm,Mm,Mm,Mm,Mm,Mm,Mm,Mm,Mm,Mm,Mm,Mm,Mm,Mm,Mm,Mm,Hh,Hh,Hh,Hh,Hh,Hh,Hh,Hh,Hh,Hh,Hh,Hh,Hh,Hh,Hh,Hh,Hh,Hh,Hh,Hh,Hh,Hh,Hh,Hh,Hh,Mm,Mm,Mm,Mm,Mm,Mm,Mm,Mm,Mm,Mm,Mm,Mm,Mm,Mm,Mm,Mm,Mm,Mm,Mm,Mm,Mm,Mm,Mm,Mm,Mm,Mm,Mm,Mm,Mm,Mm,Mm,Mm,Mm,Mm,Mm,Mm,Mm,Mm
Mm,Hh,Hh,Hh,Hh,Hh,Hh,Hh,Hh,Hh,Hh,Hh,Hh,Hh,Hh,Hh,Hh,Hh,Hh,Hh,Hh,Hh,Hh,Hh,Hh,Gg,Gs^Fp,Gs^Fp,Gs^Fp,Gg,Gg,Gg,Gg,Gg,Gg,Gg,Gg,Gs^Fp,Gs^Fp,Gs^Fp,Gg,Gg,Hh,Hh,Hh,Hh,Hh,Hh,Hh,Hh,Hh,Mm,Mm,Mm,Mm,Mm,Mm,Mm,Mm,Mm,Mm,Mm,Mm,Mm,Mm,Mm,Mm,Mm,Mm,Mm,Mm,Mm,Mm,Mm,Mm,Mm,Mm,Mm,Mm,Mm
Hh,Hh,Hh,Hh,Hh,Hh,Hh,Chr,Ch,Ch,Gg,Gg,Gg,Gs^Fp,Gs^Fp,Gg,Gg,Gg,Gg,Gs^Fp,Gg,Gg,Gg,Gg,Gg,Gg,Gg,Gg,Ww,Ww,Ww,Ww,Ww,Ww,Ww,Ww,Ww,Ww,Ww,Ww,Ww,Gg,Gs^Fp,Gs^Fp,Gg,Gg,Gg,Gg,Hh,Hh,Hh,Hh,Hh,Hh,Hh,Mm,Mm,Mm,Mm,Mm,Mm,Mm,Mm,Mm,Mm,Mm,Mm,Mm,Mm,Mm,Mm,Mm,Mm,Mm,Mm,Mm,Mm,Mm,Mm,Mm
Gg,Gg,Gs^Fp,Gs^Fp,Gs^Fp,Gg,Gg,Chr,2 Kh,Chr,Gg,Gg,Ww,Ww,Ww,Ww,Ww,Ww,Ww,Ww,Ww,Ww,Ww,Ww,Ww,Ww,Ww,Ww,Ww,Wo,Wo,Wo,Wo,Wo,Wo,Wo,Wo,Wo,Wo,Wo,Ww,Ww,Ww,Ww,Ww,Ww,Ww,Ww,Gg,Gs^Fp,Gg,Hh,Hh,Hh,Hh,Hh,Hh,Mm,Mm,Mm,Mm,Mm,Mm,Mm,Mm,Mm,Mm,Mm,Mm,Mm,Mm,Mm,Mm,Mm,Mm,Mm,Mm,Mm,Mm,Mm
Gg,Gs^Fp,Gs^Fp,Gg,Gg,Gg,Wwf,Chw,Chw,Chw,Ww,Ww,Ww,Ww,Wo,Wo,Wo,Wo,Wo,Wo,Wo,Wo,Wo,Wo,Wo,Wo,Wo,Wo,Wo,Wo,Wo,Wo,Wo,Wo,Wo,Wo,Wo,Wo,Wo,Wo,Wo,Wo,Wo,Wo,Wo,Wo,Ww,Ww,Ww,Ww,Gg,Gg,Hh,Hh,Hh,Hh,Hh,Hh,Mm,Mm,Mm,Mm,Mm,Mm,Mm,Mm,Mm,Mm,Mm,Mm,Mm,Mm,Mm,Mm,Mm,Mm,Mm,Mm,Mm,Mm
Ww,Ww,Wwf,Wwf,Wwf,Wwf,Wwf,Ww,Ww,Ww,Ww,Wo,Wo,Wo,Wo,Wo,Wo,Wo,Wo,Wo,Wo,Wo,Wo,Wo,Wo,Wo,Wo,Wo,Wo,Wo,Gg,Gg,Gs^Fp,Gg,Gg,Gg,Gg,Wo,Wo,Wo,Wo,Wo,Wo,Wo,Wo,Wo,Wo,Wo,Wo,Ww,Ww,Gs^Fp,Gg,Hh,Hh,Hh,Hh,Mm,Mm,Mm,Mm,Mm,Mm,Mm,Mm,Mm,Mm,Mm,Mm,Mm,Mm,Mm,Mm,Mm,Mm,Mm,Mm,Mm,Mm,Mm
Ww,Ww,Ww,Wwf,Wwf,Wwf,Ww,Ww,Wo,Wo,Wo,Wo,Wo,Wo,Wo,Wo,Wo,Wo,Wo,Wo,Wo,Wo,Wo,Wo,Wo,Wo,Gg,Gg,Gs^Fp,Gs^Fp,Gg,Wo,Wo,Wo,Wo,Wo,Gg,Gg,Gg,Wo,Wo,Ww^Vm,Wo,Wo,Wo,Wo,Wo,Wo,Ww,Ww,Ww,Gs^Fp,Gg,Gg,Hh,Hh,Hh,Hh,Mm,Mm,Mm,Mm,Mm,Mm,Mm,Mm,Mm,Mm,Mm,Mm,Mm,Mm,Mm,Mm,Mm,Mm,Mm,Mm,Mm,Mm
Ww,Ww,Ww,Wwf,Wwf,Ww,Ww,Wo,Wo,Wo,Wo,Wo,Wo,Wo,Wo,Wo,Wo,Wo,Wo,Wo,Ww^Vm,Wo,Wo,Wo,Wo,Wo,Gg,Mm,Gg,Ww^Vm,Wo,Wo,Chw,Chw,Chw,Wo,Wo,Wo,Gs^Fp,Gg,Wo,Wo,Wo,Wo,Wo,Wo,Wo,Wo,Wo,Ww,Ww,Gg,Gg,Gg,Gg,Gg,Gg,Gg,Hh,Mm,Mm,Mm,Mm,Mm,Mm,Mm,Mm,Mm,Mm,Mm,Mm,Mm,Mm,Mm,Mm,Mm,Mm,Mm,Mm,Mm
Ww,Ww,Wwf,Wwf,Wwf,Wwf,Ww,Wo,Wo,Wo,Wo,Wo,Wo,Wo,Wo,Wo,Wo,Wo,Wo,Wo,Wo,Wo,Wo,Gs^Fp,Gg,Wo,Wo,Gg,Gg,Wo,Wo,Chw,Chw,4 Kh,Chw,Chw,Wo,Ww^Vm,Gg,Mm,Gg,Wo,Wo,Wo,Wo,Wo,Wo,Wo,Ww,Ww,Gg,Gg,Gs^Fp,Gs^Fp,Gs^Fp,Gg,Gg,Gg,Hh,Mm,Mm,Mm,Mm,Mm,Mm,Mm,Mm,Mm,Mm,Mm,Mm,Mm,Mm,Mm,Mm,Mm,Mm,Mm,Mm,Mm
Ww,Ww,Wwf,Wwf,Wwf,Wwf,Ww,Ww,Wo,Wo,Wo,Wo,Wo,Wo,Wo,Wo,Wo,Wo,Wo,Wo,Wo,Wo,Gg,Hh,Mm,Mm,Gg,Gs^Fp,Gg,Wo,Wo,Wo,Chw,Chw,Chw,Wo,Wo,Gg,Gs^Fp,Gg,Wo,Wo,Wo,Wo,Wo,Wo,Wo,Ww,Ww,Gg,Gs^Fp,Gg,Hh,Hh,Hh,Hh,Hh,Hh,Hh,Mm,Mm,Mm,Mm,Mm,Mm,Mm,Mm,Mm,Mm,Mm,Mm,Mm,Mm,Mm,Mm,Mm,Mm,Mm,Mm,Mm
Ww,Ww,Ww,Wwf,Wwf,Ww,Ww,Ww,Ww,Ww,Wo,Wo,Wo,Wo,Wo,Wo,Wo,Wo,Wo,Wo,Wo,Wo,Wo,Gs^Fp,Gg,Hh,Gg,Ww^Vm,Wo,Wo,Wo,Wo,Wo,Wo,Wo,Wo,Wo,Wo,Wo,Wo,Wo,Wo,Wo,Wo,Wo,Wo,Wo,Ww,Ww,Gg,Gs^Fp,Gg,Hh,Hh,Hh,Hh,Mm,Mm,Mm,Mm,Mm,Mm,Mm,Mm,Mm,Mm,Mm,Mm,Mm,Mm,Mm,Mm,Mm,Mm,Mm,Mm,Mm,Mm,Mm,Mm
Ww,Ww,Wwf,Ce,Ce,Ce,Wwf,Ww,Ww,Ww,Ww,Ww,Ww,Ww,Wo,Wo,Wo,Wo,Wo,Wo,Wo,Wo,Wo,Wo,Wo,Wo,Wo,Wo,Wo,Wo,Wo,Wo,Ww^Vm,Wo,Wo,Wo,Wo,Wo,Wo,Wo,Wo,Wo,Wo,Wo,Wo,Wo,Wo,Ww,Ww,Ww,Gg,Gg,Hh,Hh,Hh,Hh,Hh,Hh,Mm,Mm,Mm,Mm,Mm,Mm,Mm,Mm,Mm,Mm,Mm,Mm,Mm,Mm,Mm,Mm,Mm,Mm,Mm,Mm,Mm,Mm
Gs^Fp,Gs^Fp,Gg,Ce,3 Kh,Ce,Gg,Gg,Gg,Gg,Gg,Gg,Ww,Ww,Ww,Ww,Ww,Wo,Wo,Wo,Wo,Wo,Wo,Wo,Wo,Ww^Vm,Wo,Wo,Wo,Wo,Wo,Wo,Wo,Wo,Wo,Wo,Wo,Wo,Ww^Vm,Wo,Wo,Wo,Wo,Wo,Wo,Wo,Ww,Ww,Ww,Ww,Ww,Gg,Gg,Hh,Hh,Hh,Hh,Hh,Hh,Hh,Hh,Hh,Hh,Hh,Hh,Mm,Mm,Mm,Mm,Mm,Mm,Mm,Mm,Mm,Mm,Mm,Mm,Mm,Mm,Mm
Hh,Hh,Hh,Hh,Ce,Gg,Gg,Gg,Gg,Gg,Gg,Gg,Gg,Gg,Ww,Ww,Ww,Ww,Ww,Wo,Wo,Wo,Wo,Wo,Wo,Wo,Wo,Wo,Wo,Wo,Wo,Wo,Wo,Wo,Wo,Wo,Wo,Wo,Wo,Wo,Wo,Wo,Wo,Wo,Wo,Wo,Ww,Ww,Ww,Ww,Ww,Ww,Gg,Gg,Gg,Gg,Gs^Fp,Gg,Gg,Gs^Fp,Gg,Gs^Fp,Gs^Fp,Gg,Hh,Hh,Hh,Hh,Hh,Hh,Hh,Hh,Hh,Mm,Mm,Mm,Mm,Mm,Mm,Mm
Mm,Mm,Mm,Hh,Hh,Hh,Hh,Hh,Gs^Fp,Gs^Fp,Gg,Gg,Gg,Gg,Gs^Fp,Gg,Gg,Ww,Ww,Ww,Ww,Ww,Ww,Ww,Wo,Wo,Wo,Wo,Wo,Wo,Wo,Wo,Wo,Wo,Wo,Wo,Wo,Wo,Wo,Wo,Wo,Wo,Wo,Ww,Ww,Ww,Ww,Ww,Ww,Ww,Ww,Ww,Ww,Gg,Gg,Ww,Ww,Ww,Ww,Ww,Ww,Ww,Ww,Ww,Gg,Gg,Gg,Gg,Gg,Gg,Gs^Fp,Gs^Fp,Hh,Hh,Hh,Hh,Mm,Mm,Mm,Mm
Mm,Mm,Mm,Mm,Mm,Mm,Hh,Hh,Hh,Hh,Hh,Ce,Ce,Ce,Gg,Gs^Fp,Gg,Gg,Ww,Ww,Ww,Ww,Ww,Ww,Ww,Ww,Ww,Ww,Wo,Wo,Wo,Wo,Wo,Wo,Wo,Wo,Wo,Wo,Wo,Wo,Ww,Ww,Ww,Ww,Ww,Ww,Ww,Ww,Ww,Ww,Ww,Ww,Ww,Ww,Ww,Ww,Ww,Ww,Ww,Ww,Ww,Ww,Ww,Ww,Ww,Ww,Ww,Ww,Ww,Ww,Ww,Ww,Gg,Gg,Gg,Hh,Mm,Mm,Mm,Mm
Mm,Mm,Mm,Mm,Mm,Mm,Mm,Mm,Mm,Mm,Hh,Ce,1 Kh,Ce,Hh,Hh,Hh,Gg,Gs^Fp,Gg,Gs^Fp,Gs^Fp,Gg,Gg,Gg,Ww,Ww,Ww,Ww,Ww,Ww,Ww,Ww,Ww,Ww,Ww,Ww,Ww,Ww,Ww,Ww,Gg,Gs^Fp,Gs^Fp,Gg,Gg,Gg,Gg,Gg,Ww,Ww,Ww,Ww,Ww,Ww,Wo,Wo,Wo,Wo,Wo,Wo,Wo,Wo,Wo,Wo,Wo,Wo,Wo,Wo,Ww,Ww,Ww,Ww,Ww,Gg,Hh,Mm,Mm,Mm,Mm
Mm,Mm,Mm,Mm,Mm,Mm,Mm,Mm,Mm,Mm,Mm,Ce,Ce,Ce,Hh,Hh,Hh,Hh,Hh,Hh,Hh,Hh,Hh,Hh,Hh,Gg,Gg,Gs^Fp,Gs^Fp,Gg,Gg,Ww,Ww,Ww,Gg,Gs^Fp,Gg,Gs^Fp,Gg,Gg,Gg,Hh,Hh,Hh,Hh,Hh,Hh,Hh,Gg,Gg,Gg,Ww,Ww,Ww,Ww,Ww,Ww,Wo,Wo,Wo,Wo,Wo,Wo,Wo,Wo,Wo,Wo,Wo,Wo,Wo,Ww,Ww,Ww,Gs^Fp,Gg,Hh,Mm,Mm,Mm,Mm
Mm,Mm,Mm,Mm,Mm,Mm,Mm,Mm,Mm,Mm,Mm,Mm,Mm,Mm,Mm,Mm,Mm,Mm,Mm,Mm,Mm,Mm,Mm,Hh,Hh,Hh,Hh,Gg,Gg,Gg,Gg,Gg,Gg,Gg,Gg,Hh,Hh,Hh,Hh,Hh,Hh,Hh,Mm,Mm,Mm,Mm,Mm,Hh,Hh,Gs^Fp,Gs^Fp,Gg,Gg,Ww,Ww,Ww,Ww,Ww,Ww,Ww,Wo,Wo,Wo,Wo,Wo,Wo,Wo,Wo,Wo,Ww,Ww,Ww,Ww,Ww,Gg,Hh,Mm,Mm,Mm,Mm
Mm,Mm,Mm,Mm,Mm,Mm,Mm,Mm,Mm,Mm,Mm,Mm,Mm,Mm,Mm,Mm,Xu,Xu,Xu,Xu,Xu,Mm,Mm,Mm,Mm,Xu,Xu,Xu,Uu,Uu,Uu,Uu,Uu,Xu,Xu,Xu,Mm,Mm,Mm,Mm,Mm,Mm,Mm,Xu,Xu,Xu,Mm,Mm,Hh,Hh,Hh,Hh,Gg,Gg,Gg,Gg,Gg,Ww,Ww,Ww,Ww,Ww,Wo,Wo,Wo,Wo,Wo,Wo,Ww,Ww,Ww,Ww,Ww,Gg,Gg,Hh,Mm,Mm,Mm,Mm
Mm,Mm,Mm,Mm,Mm,Mm,Mm,Mm,Mm,Mm,Xu,Xu,Xu,Xu,Xu,Xu,Xu,Uu^Vu,Uh,Uh,Xu,Xu,Xu,Mm,Mm,Xu,Uu^Vu,Uu,Uu,Uu,Uu,Uu,Uu,Uu,Xu,Xu,Xu,Xu,Xu,Xu,Xu,Xu,Xu,Xu,Xu,Xu,Xu,Mm,Mm,Mm,Mm,Hh,Hh,Hh,Hh,Hh,Hh,Gg,Gg,Gg,Ww,Ww,Ww,Ww,Wo,Wo,Wo,Wo,Ww,Ww,Ww,Gs^Fp,Gs^Fp,Gg,Hh,Hh,Mm,Mm,Mm,Mm
Mm,Mm,Mm,Mm,Mm,Mm,Mm,Xu,Xu,Xu,Xu,Xu,Xu,Uh,Uh,Uu,Uu,Uu,Uu,Uh,Uu,Uu^Uf,Xu,Xu,Xu,Xu,Xu,Uu,Uu,Re,Uu,Uu,Uu,Xu,Xu,Xu,Xu,Uu^Vu,Uh,Uh,Re,Re,Uh,Uh,Xu,Xu,Xu,Xu,Xu,Xu,Mm,Mm,Mm,Mm,Mm,Mm,Mm,Mm,Xu,Xu,Xu,Xu,Wo,Wo,Wo,Wo,Wo,Wo,Wo,Ww,Xu,Xu,Xu,Xu,Xu,Xu,Xu,Mm,Mm,Mm
Mm,Mm,Mm,Mm,Mm,Xu,Xu,Uu,Uh,Uu,Uu,Uu,Uu,Uu,Uu,Re,Uu,Uu,Uu,Re,Re,Uu,Uu,Uh,Xu,Xu,Uu,Uu,Uu,Re,Uu,Uh,Xu,Xu,Xu,Xu,Uh,Uh,Re,Chr,Chr,Chr,Chr,Re,Uu,Uu^Vu,Uu,Xu,Xu,Xu,Xu,Xu,Xu,Xu,Xu,Xu,Xu,Xu,Xu,Xu,Xu,Uu,Wo,Wo,Wo,Wo,Wo,Wo,Wo,Wo,Wo,Uu,Uu,Uu,Uu,Xu,Xu,Xu,Xu,Xu
Xu,Xu,Xu,Xu,Xu,Uu,Uu,Uu,Uu,Uu,Uu,Uu^Vu,Uu,Uu,Re,Uu,Xu,Xu,Xu,Uu^Uf,Uu,Uu,Uh,Uh,Uu,Re,Uh,Uu,Uu,Uu,Uu,Uu,Uu^Vu,Xu,Xu,Xu,Xu,Re,Chr,Chr,5 Kh,Chr,Chr,Re,Uu,Uu,Uu,Re,Re,Uu,Uu^Ii,Uu,Uu,Uh,Xu,Xu,Xu,Xu,Xu,Xu,Uu,Uu,Wo,Wo,Wo,Wo,Wo,Wo,Wo,Wo,Wo,Xu,Xu,Uu,Uu,Uh,Uh,Xu,Xu,Xu
Xu,Xu,Xu,Xu,Uu^Vu,Uu,Uu,Xu,Xu,Xu,Xu,Xu,Uh,Uh,Re,Uu,Uu,Xu,Xu,Xu,Uu,Uh,Uh,Uu^Vu,Uu,Uu,Re,Re,Uu,Uu,Uu,Uu,Uu,Uu^Uf,Xu,Xu,Xu,Re,Chr,Chr,Chr,Chr,Chr,Re,Uu,Uu,Uh,Uh,Uu,Uu,Re,Uu,Uu,Uh,Uh,Uh,Xu,Xu,Xu,Uu,Uu,Wo,Wo,Wo,Wo,Wo,Wo,Wo,Ww^Vm,Wo,Wo,Wo,Xu,Xu,Uu,Uu,Uh,Xu,Xu,Xu
Xu,Xu,Xu,Xu,Xu,Uu,Uu,Xu,Xu,Xu,Xu,Xu,Xu,Uh,Uh,Uu,Uu,Uu,Xu,Xu,Xu,Xu,Xu,Xu,Xu,Xu,Xu,Uh,Uu,Uu^Vu,Uu,Uh,Uu^Uf,Xu,Xu,Xu,Xu,Xu,Chr,Re,Re,Chr,Chr,Re,Uu,Uu,Xu,Xu,Xu,Xu,Uu,Re,Uu,Uu,Uu,Uu,Uu^Vu,Xu,Xu,Xu,Uu,Wo,Ww^Vm,Wo,Wo,Wo,Wo,Wo,Wo,Wo,Wo,Wo,Xu,Uu,Uu,Uu,Xu,Xu,Xu,Mm
Xu,Xu,Xu,Xu,Xu,Xu,Xu,Xu,Xu,Xu,Xu,Xu,Xu,Xu,Uu^Vu,Uu,Uu,Uu,Uu^Uf,Xu,Xu,Xu,Xu,Xu,Xu,Xu,Xu,Xu,Xu,Xu,Xu,Xu,Xu,Xu,Xu,Xu,Uu^Uf,Uu,Re,Uu,Re,Re,Re,Uu^Uf,Uu^Vu,Xu,Xu,Xu,Xu,Uu^Ii,Uu^Vu,Uu,Re,Re,Uu,Uu,Uu^Uf,Uu^Uf,Xu,Uu,Uu,Wo,Wo,Wo,Wo,Wo,Wo,Wo,Wo,Wo,Wo,Uu,Uu,Uu,Uu,Xu,Xu,Xu,Mm,Mm
Xu,Xu,Xu,Xu,Xu,Xu,Xu,Xu,Xu,Xu,Xu,Xu,Xu,Uu^Uf,Uu^Uf,Uu,Uu,Uu,Uu,Uu^Ii,Uu,Uu,Uu,Uu,Uu,Uh,Uh,Xu,Xu,Xu,Xu,Xu,Uu^Uf,Uu,Uu^Vu,Uu,Uu,Uu,Uu,Uu^Ii,Uu,Uu,Uu,Uh,Xu,Xu,Xu,Xu,Xu,Xu,Uh,Uh,Uu,Uu,Re,Uu,Uu^Uf,Xu,Xu,Uu,Wo,Wo,Wo,Wo,Wo,Wo,Wo,Wo,Wo,Wo,Wo,Uu,Uu,Uu^Ii,Xu,Xu,Xu,Xu,Mm,Mm
Uu,Uu,Xu,Xu,Xu,Xu,Xu,Xu,Uu,Uu,Uu,Uu,Uu^Ii,Uu,Uu,Uu,Uu,Uu,Re,Re,Uu,Uh,Uh,Uu,Uu,Uu,Uu,Uu,Uu,Uu,Re,Re,Re,Uu,Uu,Uu,Uh,Uh,Uu,Uu,Uu,Uh,Uh,Xu,Xu,Xu,Xu,Xu,Xu,Xu,Xu,Uu,Uh,Uh,Uu,Uu,Uu,Xu,Uu,Wwf,Wwf,Wwf,Wwf,Wwf,Wwf,Wwf,Wwf,Wo,Wo,Uu,Uu,Uu,Uh,Uu,Uu,Uu,Hh,Mm,Mm,Mm
Uh,Uu,Uu,Uu,Uu,Uu,Uu,Uu,Uu,Uu,Xu,Xu,Xu,Xu,Xu,Xu,Uu^Uf,Uu^Ii,Uu^Uf,Uu,Uh,Uh,Uh,Uh,Xu,Xu,Uu^Uf,Uu^Uf,Uu,Uu,Uh,Uh,Uh,Uu,Uu,Xu,Xu,Xu,Xu,Uu,Uu,Uu^Vu,Uh,Xu,Xu,Xu,Xu,Xu,Xu,Xu,Xu,Xu,Xu,Xu,Uu,Uu,Uu,Xu,Uu,Wwf,Wwf,Wwf,Wwf,Wwf,Wwf,Wwf,Uu,Uu,Uu,Uu,Uu,Uh,Uh,Uu,Uu,Uu,Hh,Hh,Hh,Hh
Uu,Uu,Uu,Uu,Uu,Uu^Ii,Uu,Uu,Xu,Xu,Xu,Xu,Xu,Xu,Xu,Xu,Xu,Xu,Xu,Xu,Xu,Xu,Xu,Xu,Xu,Xu,Xu,Xu,Xu,Xu,Xu,Xu,Xu,Xu,Xu,Xu,Xu,Xu,Xu,Xu,Xu,Xu,Xu,Xu,Xu,Xu,Xu,Xu,Xu,Xu,Xu,Xu,Xu,Xu,Xu,Xu,Xu,Xu,Xu,Wo,Wo,Wo,Wwf,Wwf,Wwf,Wwf,Uu,Uu^Ii,Uu,Uu,Uu,Uh,Uu,Uu,Uu,Gg,Gg,Gg,Gg,Gg
Xu,Xu,Xu,Xu,Xu,Xu,Xu,Xu,Xu,Xu,Xu,Xu,Xu,Xu,Xu,Mm,Mm,Mm,Mm,Mm,Mm,Mm,Mm,Mm,Mm,Mm,Mm,Mm,Mm,Mm,Mm,Mm,Mm,Mm,Mm,Mm,Mm,Mm,Mm,Mm,Mm,Mm,Mm,Mm,Mm,Gg,Gg,Gg,Gg,Gg,Gg,Mm,Mm,Mm,Mm,Ww,Ww,Wo,Wo,Wo,Wo,Wo,Wo,Wo,Ww^Vm,Wo,Wo,Xu,Xu,Xu,Xu,Xu,Gg,Gg,Gg,Gg,Gg,Gg,Gg,Gg
Mm,Mm,Mm,Mm,Mm,Mm,Mm,Mm,Mm,Mm,Mm,Mm,Mm,Mm,Mm,Mm,Mm,Mm,Mm,Mm,Mm,Mm,Hh,Hh,Hh,Hh,Hh,Hh,Hh,Hh,Hh,Hh,Hh,Hh,Hh,Hh,Gg,Gg,Gg,Gg,Gg,Gg,Gg,Gg,Ww,Ww,Ww,Ww,Ww,Ww,Ww,Ww,Ww,Ww^Vm,Ww,Ww,Wo,Chw,Chw,Chw,Chw,Chw,Chw,Wo,Ww,Ww,Ww,Ww,Mm,Mm,Mm,Mm,Gg,Gg,Gg,Gg,Gg,Gg,Gg,Gg
Hh,Hh,Hh,Hh,Hh,Hh,Hh,Hh,Hh,Hh,Hh,Hh,Hh,Hh,Hh,Hh,Hh,Hh,Hh,Hh,Hh,Hh,Hh,Hh,Hh,Hh,Gs^Fp,Gs^Fp,Gs^Fp,Gg,Gg,Gg,Gg,Gg,Gg,Gg,Gg,Ww,Ww,Ww,Ww,Ww,Ww,Ww,Ww,Ww,Ww,Wo,Wo,Ww^Vm,Wo,Wo,Wo,Wo,Wo,Wo,Chw,Chw,Ch,Ch,6 Kh,Ch,Chw,Ww^Vm,Wo,Wo,Ww,Ww,Ww,Ww,Ww,Ww,Ww,Ww,Ww,Gg,Gg,Gg,Gg,Gg^Vh
Gg,Gs^Fp,Gs^Fp,Gg,Gg,Gg,Gs^Fp,Gs^Fp,Gs^Fp,Gs^Fp,Gs^Fp,Gs^Fp,Gs^Fp,Gs^Fp,Gs^Fp,Gs^Fp,Gs^Fp,Gs^Fp,Gs^Fp,Gs^Fp,Gs^Fp,Gg,Gg,Gg,Gg,Gg,Gs^Fp,Gg,Gg,Gg,Ww,Ww,Ww,Ww,Ww,Ww,Wo,Wo,Wo,Wo,Wo,Wo,Wo,Wo,Wo,Wo,Wo,Wo,Wo,Wo,Wo,Ww^Vm,Wo,Wo,Wo,Ww^Vm,Wo,Wo,Chw,Ch,Ch,Chw,Chw,Wo,Wo,Wo,Ww^Vm,Wo,Wo,Wo,Wo,Wo,Ww,Ww,Ww,Gg,Gg,Gg,Gg,Gg