border_size=1
usage=map

       Aa,       Aa,       Ha,       Ha,       Aa,       Ha,       Ha,       Aa,       Aa,       Aa,       Mm,       Ha,       Ha,       Ha,       Ha,       Ha,       Ha,       Mm,       Mm,       Mm,       Mm,       Mm,       Mm,       Mm,       Mm,       Mm,       Mm,       Mm,       Mm,       Mm,       Mm,       Mm,       Mm,       Mm,       Mm,       Mm,       Mm,       Mm,       Mm,       Mm
       Aa,       Aa,       Ha,       Ha,       Aa,       Ha,       Ha,       Aa,       Aa,       Aa,       Mm,       Ha,       Ha,       Ha,       Ha,       Ha,       Ha,       Mm,       Mm,       Mm,       Mm,       Mm,       Mm,       Mm,       Mm,       Mm,       Mm,       Mm,       Mm,       Mm,       Mm,       Mm,       Mm,       Mm,       Mm,       Mm,       Mm,       Mm,       Mm,       Mm
       Aa,       Aa,       Aa,       Aa,       Aa,       Aa,       Mm,       Mm,       Mm,       Mm,       Ha,       Ha,       Mm,       Ha,       Ha,       Ha,       Ha,       Ha,       Ha,       Ha,       Ha,       Mm,       Mm,       Mm,       Ha,       Mm,       Mm,       Mm,       Mm,       Mm,       Mm,       Mm,       Mm,       Mm,       Mm,       Mm,       Mm,       Mm,       Mm,       Mm
       Aa,       Aa,       Aa,       Aa,       Aa,       Aa,       Ha,       Mm,       Ha,       Mm,       Mm,       Mm,       Aa,       Mm,       Ha,       Ha,       Mm,       Ha,       Ha,       Ha,       Ha,       Ha,       Ha,       Mm,       Mm,       Mm,       Mm,       Mm,       Mm,       Mm,       Mm,       Mm,       Mm,       Mm,       Mm,       Mm,       Mm,       Mm,       Mm,       Mm
       Aa,       Aa,       Gg,       Aa,       Gg,       Aa,       Aa,       Ha,       Ha,       Ha,       Aa,       Aa,       Mm,       Aa,       Mm,       Mm,       Mm,       Ha,       Mm,       Mm,       Mm,       Mm,       Ha,       Ha,       Ha,       Ha,       Mm,       Mm,       Mm,       Mm,       Ch,       Mm,       Mm,       Mm,       Mm,       Mm,       Mm,       Mm,       Mm,       Mm
       Gg,       Gg,       Aa,       Gg,       Aa,       Gg,       Gg,       Aa,       Aa,       Aa,       Aa,       Aa,       Ha,       Mm,       Ha,       Mm,       Ha,       Ha,   Aa^Fpa,       Ha,       Ha,       Ha,       Mm,       Ha,       Ha,       Mm,       Mm,       Mm,       Mm,       Ch,       Ch,       Mm,       Mm,       Mm,       Mm,       Mm,       Mm,       Mm,       Mm,       Mm
       Aa,       Aa,       Aa,       Aa,       Gg,       Gg,       Gg,       Gg,       Gg,       Aa,       Aa,       Ha,       Ha,       Ha,       Ha,       Ha,       Aa,   Aa^Vha,       Aa,   Aa^Fpa,   Aa^Fpa,       Mm,   Aa^Fpa,       Mm,       Ha,       Ha,       Ha,       Ha,       Ha,       Ch,       Mm,       Mm,       Mm,       Mm,       Mm,       Mm,       Mm,       Mm,       Mm,       Mm
       Aa,       Aa,       Gg,       Gg,       Gg,       Gg,    Gg^Ve,       Gg,       Gg,       Aa,       Gg,       Ha,       Aa,       Ha,       Aa,       Aa,       Aa,       Aa,   Aa^Fpa,   Aa^Fpa,   Aa^Fpa,   Aa^Fpa,   Aa^Fpa,       Ha,       Aa,       Ha,       Ha,       Ha,       Aa,       Ha,       Ha,       Mm,       Ha,       Mm,       Mm,       Mm,       Mm,       Mm,       Mm,       Mm
       Gg,       Gg,    Gg^Ve,       Gg,       Gg,       Gg,       Gg,       Gg,       Gg,       Gg,       Gg,       Gg,       Gg,       Aa,       Gg,       Aa,       Gg,       Aa,       Aa,   Aa^Fpa,   Aa^Fpa,   Aa^Fpa,   Aa^Fpa,   Aa^Fpa,   Aa^Fpa,       Aa,       Aa,       Ha,       Aa,       Ha,       Ha,       Mm,       Mm,       Mm,       Mm,       Mm,       Mm,       Mm,       Mm,       Mm
       Gg,       Gg,       Gg,       Gg,       Gg,       Gg,       Gg,       Gg,       Gg,       Gg,       Gg,       Gg,       Aa,       Gg,       Aa,       Gg,       Gg,       Aa,       Aa,   Aa^Fpa,   Aa^Fpa,   Aa^Fpa,   Aa^Fpa,   Aa^Fpa,       Aa,       Aa,       Aa,       Aa,       Aa,       Aa,       Ha,       Ha,       Ha,       Ha,       Mm,       Mm,       Mm,       Mm,       Mm,       Mm
    Gs^Fp,    Gs^Fp,    Gs^Fp,       Gg,       Gg,       Gg,       Gg,       Gg,       Gg,       Gg,       Gg,       Gg,       Gg,       Aa,       Aa,       Aa,       Gg,    Gg^Ve,       Aa,       Aa,       Aa,   Aa^Fpa,   Aa^Fpa,       Aa,   Aa^Vha,       Aa,       Aa,   Aa^Fpa,   Aa^Fpa,       Aa,   Aa^Fpa,   Aa^Fpa,       Ha,       Mm,       Ha,       Ha,       Ha,       Mm,       Ha,       Ha
    Gs^Fp,    Gs^Fp,    Gs^Fp,       Gg,       Gg,       Gg,    Gs^Fp,    Gs^Fp,    Gs^Fp,       Gg,       Gg,       Gg,       Gg,       Gg,       Gg,       Gg,       Gg,       Aa,       Gg,       Aa,       Aa,   Aa^Fpa,   Aa^Fpa,       Aa,       Aa,       Aa,   Aa^Fpa,   Aa^Fpa,   Aa^Fpa,       Aa,   Aa^Fpa,   Aa^Fpa,       Aa,       Ha,       Aa,       Aa,       Aa,       Ha,       Aa,       Aa
       Re,       Re,       Re,       Re,    Gs^Fp,       Gg,    Gs^Fp,    Gs^Fp,    Gs^Fp,    Gg^Ve,       Gg,       Gg,    Gs^Fp,       Gg,       Gg,       Gg,       Gg,       Gg,       Gg,       Gg,       Gg,       Aa,       Aa,       Aa,       Aa,       Aa,       Aa,   Aa^Fpa,   Aa^Fpa,   Aa^Fpa,   Aa^Fpa,       Aa,       Aa,       Aa,       Aa,       Aa,       Aa,       Aa,       Aa,       Aa
       Re,       Re,       Hh,       Re,    Gs^Fp,    Gs^Fp,    Gs^Fp,    Gs^Fp,    Gs^Fp,    Gs^Fp,    Gs^Fp,       Gg,    Gs^Fp,    Gs^Fp,       Gg,       Gg,       Gg,       Gg,       Gg,       Gg,       Gg,       Gg,       Gg,       Aa,       Aa,       Aa,       Aa,       Aa,       Aa,   Aa^Fpa,       Aa,   Aa^Fpa,   Aa^Fpa,       Aa,       Aa,       Aa,   Aa^Fpa,       Aa,   Aa^Fpa,   Aa^Fpa
       Re,       Re,       Hh,       Hh,       Hh,    Gs^Fp,       Hh,    Gs^Fp,    Gs^Fp,    Gs^Fp,    Gs^Fp,    Gs^Fp,    Gs^Fp,       Gg,       Gg,       Gg,    Gs^Fp,       Gg,       Hh,       Hh,       Gg,       Gg,       Gg,       Gg,       Aa,       Aa,       Aa,   Aa^Vha,       Aa,       Aa,       Aa,   Aa^Fpa,   Aa^Fpa,       Aa,   Aa^Fpa,   Aa^Fpa,   Aa^Fpa,   Aa^Fpa,   Aa^Fpa,   Aa^Fpa
       Re,       Re,       Hh,       Hh,    Gs^Fp,       Hh,       Hh,    Gs^Fp,       Hh,    Gs^Fp,    Gs^Fp,    Gs^Fp,    Gs^Fp,    Gs^Fp,       Gg,       Gg,    Gs^Fp,       Hh,       Hh,       Hh,       Gg,       Hh,       Hh,       Gg,       Gg,       Gg,       Gg,       Aa,       Gg,       Aa,       Gg,       Aa,       Aa,   Aa^Fpa,       Gg,   Aa^Fpa,       Gg,   Aa^Fpa,   Aa^Fpa,   Aa^Fpa
       Re,       Re,       Re,       Hh,       Hh,       Hh,       Hh,       Re,       Hh,       Hh,       Re,    Gg^Ve,       Gg,       Gg,       Gg,       Gg,       Gg,       Hh,       Hh,       Hh,    Gs^Fp,       Gg,       Hh,       Hh,       Gg,       Gg,       Gg,       Gg,       Gg,       Gg,       Gg,       Gg,       Gg,       Gg,       Gg,       Gg,       Gg,   Aa^Fpa,   Aa^Fpa,   Aa^Fpa
       Hh,       Hh,       Hh,    Gg^Ve,       Hh,       Re,       Hh,       Hh,       Hh,       Hh,       Hh,       Hh,       Hh,       Gg,       Hh,       Hh,       Hh,       Gg,       Gg,       Gg,    Gs^Fp,       Hh,    Gs^Fp,       Hh,       Hh,       Gg,       Gg,       Gg,       Gg,       Gg,       Gg,       Gg,       Gg,    Gs^Fp,    Gs^Fp,    Gs^Fp,       Gg,       Gg,   Aa^Fpa,   Aa^Fpa
       Hh,       Hh,       Hh,       Hh,       Hh,       Hh,       Hh,    Gg^Ve,       Re,       Hh,       Re,    Gs^Fp,       Re,    Gs^Fp,    Gg^Ve,       Hh,       Hh,    Gs^Fp,    Gs^Fp,       Gg,       Gg,    Gs^Fp,    Gs^Fp,    Gs^Fp,       Hh,       Gg,       Gg,    Gg^Ve,    Gs^Fp,       Gg,       Gg,       Gg,       Gg,    Gs^Fp,    Gs^Fp,    Gs^Fp,       Gg,       Gg,       Gg,       Gg
       Hh,       Hh,       Hh,       Re,       Hh,       Hh,       Re,       Hh,       Re,       Re,       Hh,       Re,       Re,       Re,       Re,       Gg,    Gs^Fp,    Gs^Fp,    Gs^Fp,       Gg,       Hh,    Gs^Fp,       Hh,       Gg,       Hh,       Hh,       Gg,       Gg,    Gs^Fp,    Gs^Fp,    Gs^Fp,       Gg,       Gg,       Gg,       Gg,       Gg,       Gg,       Gg,       Gg,       Gg
       Hh,       Hh,       Hh,       Re,       Re,       Hh,       Hh,       Re,       Hh,       Hh,       Ch,     2 Kh,       Ch,       Re,       Re,    Gs^Fp,       Re,    Gs^Fp,       Gg,       Gg,       Gg,       Hh,       Gg,       Gg,       Gg,       Hh,       Gg,       Gg,       Hh,    Gs^Fp,       Gg,    Gs^Fp,       Gg,       Gg,    Gg^Ve,       Gg,       Gg,       Gg,       Gg,       Gg
       Mm,       Mm,       Hh,       Re,    Gg^Ve,       Re,       Re,       Hh,       Hh,       Re,       Re,       Ch,       Hh,       Hh,       Hh,       Hh,       Hh,       Re,       Gg,       Gg,       Hh,       Gg,       Hh,       Hh,       Hh,       Gg,       Gg,       Hh,       Gg,       Gg,       Gg,    Gs^Fp,       Gg,       Gg,       Gg,       Gg,       Gg,    Gg^Ve,       Gg,       Gg
       Mm,       Mm,       Mm,       Hh,       Hh,       Hh,       Hh,       Hh,       Hh,       Hh,       Hh,       Re,    Gg^Ve,       Hh,       Re,       Hh,       Re,    Gg^Ve,       Gg,       Gg,       Hh,       Hh,       Hh,       Hh,       Hh,       Hh,       Hh,       Hh,       Hh,       Gg,       Gg,       Gg,       Gg,       Gg,       Gg,       Gg,       Ch,       Gg,       Gg,       Gg
       Mm,       Mm,       Mm,       Mm,       Hh,       Hh,       Hh,       Hh,       Hh,       Hh,       Hh,       Hh,       Hh,       Re,       Re,       Re,       Hh,       Mm,       Re,       Gg,       Gg,       Hh,       Gg,       Hh,       Hh,       Hh,       Hh,       Hh,       Hh,       Hh,       Gg,    Gg^Ve,       Gg,       Gg,       Gg,       Ch,     1 Kh,       Ch,       Gg,       Gg
       Mm,       Mm,       Mm,       Mm,       Mm,       Hh,       Hh,       Hh,       Hh,       Hh,       Hh,       Hh,       Hh,       Hh,       Mm,       Hh,       Mm,       Mm,       Mm,       Mm,       Mm,       Mm,       Re,       Gg,       Gg,       Hh,       Hh,       Hh,       Hh,       Hh,    Gs^Fp,    Gs^Fp,    Gs^Fp,       Gg,       Gg,       Gg,       Gg,       Ch,       Gg,       Gg
       Mm,       Mm,       Mm,       Mm,       Mm,       Mm,       Mm,       Mm,       Mm,       Mm,       Mm,       Mm,       Mm,       Mm,       Mm,       Mm,       Mm,       Mm,       Mm,       Mm,       Mm,       Mm,       Mm,       Re,       Gg,    Gg^Ve,       Re,       Hh,       Re,       Hh,       Hh,    Gs^Fp,    Gs^Fp,    Gs^Fp,    Gs^Fp,       Gg,    Gs^Fp,    Gs^Fp,    Gs^Fp,    Gs^Fp
       Mm,       Mm,       Mm,       Mm,       Mm,       Mm,       Mm,       Mm,       Mm,       Mm,       Mm,       Mm,       Mm,       Mm,       Mm,       Mm,       Hh,       Hh,       Hh,       Hh,       Mm,       Mm,       Hh,       Re,       Hh,       Re,       Hh,       Re,       Re,       Hh,       Hh,       Hh,       Hh,    Gs^Fp,       Hh,    Gs^Fp,    Gs^Fp,    Gs^Fp,    Gs^Fp,    Gs^Fp
       Mm,       Mm,       Mm,       Mm,       Mm,       Mm,       Mm,       Mm,       Mm,       Mm,       Mm,       Mm,       Mm,       Mm,       Mm,       Hh,       Hh,       Hh,       Hh,       Hh,       Hh,       Mm,       Hh,       Hh,       Hh,       Hh,       Hh,       Hh,       Hh,       Hh,       Hh,       Hh,       Hh,       Hh,       Hh,    Gs^Fp,       Hh,    Gs^Fp,    Gs^Fp,    Gs^Fp
       Mm,       Mm,       Mm,       Mm,       Mm,       Mm,       Mm,       Mm,       Mm,       Mm,       Mm,       Mm,       Mm,       Mm,       Mm,       Hh,       Hh,       Hh,       Hh,       Hh,       Mm,       Hh,       Mm,       Mm,       Mm,       Hh,       Hh,       Hh,       Hh,       Hh,       Hh,       Hh,       Hh,       Hh,       Hh,       Hh,       Hh,       Hh,       Hh,       Hh
       Mm,       Mm,       Mm,       Mm,       Mm,       Mm,       Mm,       Mm,       Mm,       Mm,       Mm,       Mm,       Mm,       Mm,       Mm,       Mm,       Hh,       Hh,       Hh,       Hh,       Hh,       Mm,       Mm,       Mm,       Mm,       Mm,       Mm,       Mm,       Mm,       Hh,       Mm,       Hh,       Mm,       Hh,       Mm,       Mm,       Mm,       Mm,       Mm,       Mm
       Mm,       Mm,       Mm,       Mm,       Mm,       Mm,       Mm,       Mm,       Mm,       Mm,       Mm,       Mm,       Mm,       Mm,       Mm,       Mm,       Mm,       Mm,       Mm,       Hh,       Mm,       Mm,       Mm,       Hh,       Mm,       Hh,       Mm,       Mm,       Mm,       Mm,       Mm,       Mm,       Mm,       Mm,       Mm,       Mm,       Mm,       Mm,       Mm,       Mm
       Mm,       Mm,       Mm,       Mm,       Mm,       Mm,       Mm,       Mm,       Mm,       Mm,       Mm,       Mm,       Mm,       Mm,       Mm,       Mm,       Mm,       Mm,       Mm,       Hh,       Mm,       Mm,       Mm,       Hh,       Mm,       Hh,       Mm,       Mm,       Mm,       Mm,       Mm,       Mm,       Mm,       Mm,       Mm,       Mm,       Mm,       Mm,       Mm,       Mm
